ӄԓявыԓя риӄукэтэ ивнин ытри ынкы варкыт гынин ӈэвъэн гэԓгыԓин мэмыԓя рагтыгъэ	ӄ ԓ я в ы ԓ _ я _ р и ӄ у к э _ тэ _ и в _ ни _ н _ ы т р и _ ы н _ кы _ в а р к ы _ т _ г ы н _ ин _ ӈ э в ъ э _ н _ г э _  ԓ г ы _ ԓин _ м э м ы ԓ _  я _ р а _ гты _  г ъ э _ 
ӄԓявыԓ ынкъам купрэн ынанъомрычьын	 ӄ ԓ я в ы ԓ _ ы н к ъ а м _ к у п р э н _ ы н а н ъ о м р ы _  ч ь ы _  н _ 
рытэнмавнэн ынӄо эргатык эквэтгъэт копрантыватысӄэквъат	 р ы т э _ нм _ ав _  н э н _ ы н ӄ о _ э р г _ атык _ э к в э т _  г ъ э _ т _ к о п р а _  н т ы в _ аты _  с ӄ э к _  в ъ а _ т _ 
риӄукэтэ гамгаваны нэнайӈоткоӄэн ӄоԓ	 р и ӄ у к э _ тэ _ г а _  м г а в _  а н ы _ н _ эна _  й ӈ о _  т к о _  ӄ э н _ ӄ о ԓ _ 
ԓьунин ынӄо йыӈотконэн	 ԓ ь у _ ни _ н _ ы н ӄ о _ й ы ӈ о _ тко _  н э _ н _ 
 эвын коԓё	 _ э в ы н _ к о ԓ ё _ 
тыкгаткэта ивнин риӄукэтэ	 т ы _  к г а т _  к э _  т а _ и в _ ни _ н _ р и ӄ у к э _ тэ _ 
йыӈотконэн эвын коԓё	 й ы ӈ о _ тко _  н э _ н _ э в ы н _ к о ԓ ё _ 
тыкгаткэта	 т ы _  к г а т _  к э _  т а _ 
ивнин риӄукэтэ ынкы	 и в _ ни _ н _ р и ӄ у к э _ тэ _ ы н _ кы _ 
рытваннэнат риӄукэтэ ивнин	 р ы т в а _  н _  н э _  н а _ т _ р и ӄ у к э _ тэ _ и в _ ни _ н _ 
мачынан ынкы нытваркын ынӄо	 м а ч ы _ нан _ ы н _ кы _ н ы _ тва _  р к ы н _ ы н ӄ о _ 
эргатык купрэт ёпаннэнат эвын гакваԓен	 э р г _ атык _ к у п р э т _ ё _  п а н _ нэ _  н а _ т _ э в ы н _ г а к в а _  ԓ е н _ 
ӈавмэмыԓчыӈын ынӄо рырагтаннэн ынкъам	 ӈ а в м э м ы _  ԓ ч ы _ ӈы _ н _ ы н ӄ о _ р ы _  р а _ гт _  а н _ нэ _ н _ ы н к ъ а м _ 
тэнуйгын йыннин	 т э н у _  й г ы _ н _ й ы н _  н и _ н _ 
ыттъын ратвынэн рывэнӈынин	 ы т т ъ ы _ н _ р а _  т в ы _ нэн _ р ы в э н ӈ ы _  н и н _ 
авынаёԓьэты ԓинԓиӈ йытонэн мэмыԓыткынык рытриԓнин ынӄо ӄԓявыԓ	 а в ы н а ё ԓ ь _  э т ы _ ԓ и н _  ԓ и ӈ _ й ы т о _  н э _  н _ м э м ы _  ԓ ы т к ы н ы _ к _ р ы т _ риԓ _ ни _ н _ ы н ӄ о _ ӄ ԓ я в ы ԓ _ 
ӈытогъэ этъоӄайӄын рэсӄиквъи ԓюур	 ӈ ы т о _ гъ _ э _ э т ъ о _  ӄ а й _  ӄ ы н _ р э с _ ӄ _ ик _ въ _ и _ ԓ ю у р _ 
рымъэйӈэнин ӄԓявыԓя	 р ы м _  ъ э й ӈ э _ ни _ н _ ӄ ԓ я в ы ԓ _ я _ 
ивнин ивнин ӈэвъэнйыръэ с амыным	 и в _ ни _ н _ и в _ ни _ н _ ӈ э в ъ э н _  й ы р ъ _ э _ с _ а м _ ыным _ 
аны ԓыгитэнчимгъуԓьын ӈэвысӄэтӄэй чама	 а н ы _ ԓ ы г и т э _  н _  ч и м г ъ у _  ԓ ь ы _ н _ ӈ э в ы с ӄ э т _  ӄ э й _ ч а м а _ 
ныԓгэнываӈэӄэн ытԓыгэ ытԓьата	 ны _  ԓ г э _ ны _  в а ӈ э _ ӄэн _ ы т ԓ ы г _ э _ ы т ԓ ь а _ та _ 
ынкъам	 ы н к ъ а м _ 
ытԓенъюрык гыԓёо ныԓгыӄин ытԓён энмэн	 ы т ԓ е н _  ъ ю р ы _  к _ г ы ԓ ё о _ н ы _ ԓгы _  ӄ и н _ ы т ԓ ё н _ э н м э н _ 
ӄуԓинымнымык	 ӄ у ԓ и _  н ы м н ы _ мык _ 
ӄоԓ гатъыԓыӈоԓен ӈэвысӄэтӄэй амыным	 ӄ о ԓ _ г а _  т ъ ы ԓ ы _ ӈо _  ԓ е н _ ӈ э в ы с ӄ э т _  ӄ э й _ а м _  ы н ы м _ 
аны ԓыгитэнчимгъуԓьын ӈэвысӄэтӄэй чама ныԓгэнываӈэӄэн ытԓыгэ ытԓьата ынкъам ытԓенъюрык гыԓёо ныԓгыӄин ытԓён ынкыым мэтчымчек нытваӄэн нымнымӄэйык ӄоԓ эӈэӈыԓьын	 а н ы _ ԓ ы г и т э _  н _  ч и м г ъ у _  ԓ ь ы _ н _ ӈ э в ы с ӄ э т _  ӄ э й _ ч а м а _ н ы _  ԓ г э _ ны _  в а ӈ э _  ӄ э н _ ы т ԓ ы г _ э _ ы т ԓ ь а _ та _ ы н к ъ а м _ ы т ԓ е н _  ъ ю р ы _  к _ г ы ԓ ё о _ н ы _ ԓгы _  ӄ и н _ ы т ԓ ё н _ ы н _  к _ ыым _ м э т _  ч ы м ч _ е _  к _ н ы _ тва _ ӄэн _ н ы м н ы м _  ӄ э й _  ы к _ ӄ о ԓ _ э ӈ э ӈ ы _ ԓьы _ н _ 
ӄынвэр ытԓыгын иквъи	 ӄ ы н в э р _ ы т ԓ ы г ы _ н _ и к _ въ _ и _ 
наӄам ӈутку варкын мэтчымче	 н а ӄ а м _ ӈ у т к у _ в а _  р к ы н _ м э т _  ч ы м ч _ е _ 
нымнымӄэйык ԓыӈыр амытва рытъё эӈэӈыԓьын ӈэвъэнэ ивнин юрэӄым нъынмэԓевэннин наӄам	 н ы м н ы м _  ӄ э й _  ы к _ ԓ ы ӈ ы р _ а м ы т в а _ р ы т ъ _  ё _ э ӈ э ӈ ы _ ԓьы _ н _ ӈ э в ъ э н _ э _ и в _ ни _ н _ ю р э _ ӄым _ н _  ъ ы н м э ԓ е в _  э н _  н и _ н _ н а ӄ а м _ 
ытԓенъюӄэгти нытэргыръоӄэнат ԓиӈвиттэ чакэттэты эквэтгъи	 ы т ԓ е н _  ъ ю ӄ э г _  т и _ н ы _  т э р г ы _  р ъ о _ ӄэна _ т _ ԓ и ӈ _  в и т _  т э _ ч а к э т _  т э т ы _ э к в э т _ гъ _ и _ 
ытԓыгын аӈаӈыԓьэты пыкиргъи нымнымӄэйык иквъэт эмитԓёным	 ы т ԓ ы г ы _ н _ а ӈ а ӈ ы _ ԓь _ эты _ п ы к и р _  г ъ _ и _ н ы м н ы м _  ӄ э й _  ы к _ и к _  в ъ э _ т _ э _  м и т ԓ ё н ы м _ 
ынин яраӈы ӄытгъи ӈэнри ярачыкогты рэсӄиквъи ԓюур вай начайпатгъан чайпанмаым нывэтгавчетӄэнат нэнамӈыԓёӄэн рэмкыԓьын	 ы н _  и н _ я р а _  ӈ ы _ ӄ ы т _ гъ _ и _ ӈ э н _  р и _ я р а _  ч ы к о _  г т ы _ р э с _ ӄ _ ик _ въ _ и _ ԓ ю у р _ в а й _ н а ч а й _  п а т _  г ъ а _  н _ ч а й _  п а н _  м а ы м _ н ы _  в э т г а в _  ч е т _ ӄэна _ т _ н _  э н а _  м ӈ ы ԓ ё _  ӄ э н _ р э м к ы _ ԓьы _ н _ 
мэӈӄо етгъи чаёпԓыткогъат ынӄо эквэтгъэт пыкиргъэт ԓыгэн	 м э ӈ _  ӄ о _ е т _  г ъ _ и _ ч а _ ё _  п ԓ ы т к о _  г ъ а _  т _ ы н ӄ о _ э к в э т _  г ъ э _ т _ п ы к и р _ гъэ _ т _ ԓ ы г э н _ 
эвыр йъонэн тъытԓьэн эчги	 э в ы р _ й ъ о _ нэ _ н _ т ъ ы т ԓ ь э _ н _ э ч г и _ 
вуԓӄытвигъи ынраӄ эԓьоткомгой коԓё	 в у ԓ ӄ ы _ тви _  г ъ _ и _ ы н р а _ ӄ _ э _  ԓ ь о _  т к о _  м г о й _ к о ԓ ё _ 
аны ныԓгикэԓьэткуԓьэтӄин чама ԓыгэн ныԓгэярарпэгԓяръоӄэн наӄам тъытԓьэн ыныкгиӈкы нинэнтыӄин эргатык ԓыгинъэ кыеквъи эӈэӈыԓьын	 а н ы _ н ы _  ԓ г и _  к э _  ԓ ь э т к у _  ԓ ь э т _ ӄин _ ч а м а _ ԓ ы г э н _ н ы _  ԓ г э _  я р а _  р п э г ԓ я _  р ъ о _  ӄ э н _ н а ӄ а м _ т ъ ы т ԓ ь э _ н _ ы н ы _  к г и ӈ _  к ы _ н _ инэ _  н т ы _  ӄ и н _ э р г _ атык _ ԓ ы г и _  н ъ _ э _ к ы е к _ въ _ и _ э ӈ э ӈ ы _ ԓьы _ н _ 
рыгъевнин тъытԓьэн ынкы вусӄымчыку нэнанпэгԓяръовӄэн	 р ы _ гъев _ ни _ н _ т ъ ы т ԓ ь э _ н _ ы н _ кы _ в у с ӄ ы м _ чыку _ н _  э н а _  н _  п э г ԓ я _  р ъ о в _ ӄэн _ 
ԓыгэн икумиӈкыри нинэнтивыӄин	 ԓ ы г э н _ и к у _ миӈ _ кы _ ри _ н _ инэ _  н т _  и в ы _  ӄ и н _ 
ынӄо тъэче кивыткугъиым иквъи итыкым	 ы н ӄ о _ т ъ э ч _ е _ к и в ы _ тку _  г ъ _ и _  ы м _ и к _ въ _ и _ и т ы _ кым _ 
вай ԓыгэн ӈэранъыԓё рэмэԓеквъэ нивӄинэт авынраԓьыт вынэ ынан мытрэркурӈын ӄынвэр рагтыгъэ эӈэӈыԓьын авынраԓьа ыныкагты	 в а й _ ԓ ы г э н _ ӈ э р а _ нъыԓё _ р э м э ԓ е к _ въ _ э _ н _ ив _  ӄ и н э _ т _ а в ы н р а _  ԓ ь ы _ т _ в ы н э _ ы н а н _ м ы т _ рэ _  р к у р _  ӈ ы _ н _ ӄ ы н в э р _ р а _ гты _  г ъ э _ э ӈ э ӈ ы _ ԓьы _ н _ а в ы н р а _  ԓ ь а _ ы н ы _  к а _ гты _ 
нэймитын ԓыгэчьыԓьын раквытчыӈын ынкъам ԓымӈэ мооӄор	 н _  э й м и _ ты _  н _ ԓ ы г э ч ь ы _ ԓьы _ н _ р а к в ы т ч ы _ ӈы _ н _ ы н к ъ а м _ ԓ ы м _ ӈэ _ м о о _  ӄ о р _ 
ынӄоры рэмкын	 ы н ӄ о р ы _ р э м к ы _ н _ 
эраткомгоӈӈой аны таӈэтъо	 э р а _  т к о _  м г о _  ӈ ӈ о _  й _ а н ы _ т а ӈ _  э т ъ о _ 
ӈэвысӄэтӄэй гаԓгэтъыԓыӈоԓен тэкэм ԓюур вай эрама	 ӈ э в ы с ӄ э т _  ӄ э й _ г а _  ԓ г э _  т ъ ы ԓ ы _  ӈ о _  ԓ е н _ т э к _ эм _ ԓ ю у р _ в а й _ э р а м _  а _ 
въигъи наӄам ӄытԓыги ԓюӈынмэԓевэтэ рыннин	 в ъ и г _ ъ _ и _ н а ӄ а м _ ӄ ы т ԓ ы г и _ ԓ ю ӈ ы _  н м э ԓ _  е в э т _  э _ р ы н _ нин _ 
ынӄоым ынӄэн эӈэӈыԓьын	 ы н ӄ о ы м _ ы н ӄ э н _ э ӈ э ӈ ы _ ԓьы _ н _ 
танԓёнръэԓягта гитԓин ԓыгэн таӈӄонпы эвытрыкэ гэнъэтԓин	 т а н ԓ ё н _  р ъ э ԓ я _  г т а _ г _  и т _ ԓин _ ԓ ы г э н _ т а ӈ _  ӄ о н п ы _ э в ы т р ы _  к _ э _ г э _ нъэт _ ԓин _ 
этъым ԓыгэыяагты гаяԓгытԓен ымто амын ӄэгԓынангэт эты эӈэӈыԓьыт ныԓгинъыръыӄинэт с энмэн нивӄин ынанчинит ынӄэн	 э т _ ъым _ ԓ ы г э _  ы я а _ гты _ г а _  я ԓ г ы т _  ԓ е н _ ы м т о _ а м _  ы н _ ӄ э г ԓ ы _ нан _ гэт _ э т ы _ э ӈ э ӈ ы _  ԓ ь ы _  т _ н ы _ ԓги _  н _  ъ ы р ъ ы _  ӄ и н э _ т _ с _ э н м э н _ н _  и в _ ӄин _ ы н а н _  ч и н и т _ ы н ӄ э н _ 
гатваԓен тэԓенъеп энмэн нивӄин ынанчинит эвыр	 г а _  т в а _ ԓен _ т э ԓ е н ъ _ еп _ э н м э н _ н _ ив _ ӄин _ ы н а н _  ч и н и т _ э в ы р _ 
мэӈин ратъыԓыӈоркын	 м э ӈ _ ин _ р а _  т ъ ы ԓ ы _  ӈ о _  р к ы н _ 
ӄэнагтыркынэтык ымыԓьо амӄынъычо	 ӄ _  э н а _  г т ы _  р к ы н э _ тык _ ы м ы ԓ ь о _ а м _  ӄ ы н _ ъычо _ 
нинивӄинэт ымыԓьо гатакэчгыӄайма ӄитгытык ӄываԓёмгытык ыныкит	 н _  и н _ ив _  ӄ и н э _ т _ ы м ы ԓ ь о _ г а _  т а к э ч _  г ы _  ӄ а й м а _ ӄ _  и т г ы _ тык _ ӄ ы _  в а ԓ ё м г ы _ тык _ ы н ы _ кит _ 
ыннэн уйӈэ	 ы н н э н _ у й ӈ э _ 
этэкичгыӄэйкэ ритгъэ ӄоԓ	 э т э к _  и ч г ы _  ӄ э й _  к _  э _ р и т _  г ъ э _ ӄ о ԓ _ 
ынин ройыръыкэн рэвъигъэ эргатык ӄытръугъэт ымыԓьо гэтэкичгэ гитԓинэт ӄоԓетъыԓё ӄутынин	 ы н _  и н _ р о _  й ы р ъ ы _  к э н _ р э в ъ и _ гъ _ э _ э р г _ атык _ ӄ ы т р ъ у _ гъэ _ т _ ы м ы ԓ ь о _ г э _  т э к и ч г _  э _ г _  и т _  ԓ и н э _ т _ ӄ о ԓ е _ тъыԓё _ ӄ у т ы _  н и н _ 
экык тъыԓыӈогъэ эргатык	 э к ы к _ т ъ ы ԓ _ ыӈо _ гъ _ э _ э р г _ атык _ 
йыннэн	 й ы н _  н э н _ 
эӈэӈыԓьын иквъи эӈэӈыԓьэ	 э ӈ э ӈ ы _ ԓьы _ н _ и к _ въ _ и _ э ӈ э ӈ ы _ ԓь _ э _ 
ивнин эргатык ӄытгъи эӈэӈыԓьын	 и в _ ни _ н _ э р г _ атык _ ӄ ы т _ гъ _ и _ э ӈ э ӈ ы _ ԓьы _ н _ 
эвын гъэӄэрэԓин тъытԓьэн	 э в ы н _ г _  ъ э ӄ э р э _ ԓин _ т ъ ы т ԓ ь э _ н _ 
атав иԓьуткугъи авынэԓьоткогты въигъи	 а т а в _ и ԓ ь у т к у _  г ъ _ и _ а в ы н э _  ԓ ь о _ тко _  г т ы _ в ъ и г _ ъ _ и _ 
экык ԓюур	 э к ы к _ ԓ ю у р _ 
ытԓыгын иквъи эӈэӈыԓьэ пынԓёнэнат еп гымнан гымнин иԓьуткукэԓы эйӈэвкэ еп	 ы т ԓ ы г ы _ н _ и к _ въ _ и _ э ӈ э ӈ ы _ ԓь _ э _ п ы н ԓ ё н _ эна _ т _ е п _ г ы м _  н а н _ г ы м _  н и н _ и ԓ ь у т к у _  к э ԓ ы _ э й ӈ э в _  к _ э _ е п _ 
эпкиркэ въигъи ыныкит нъыпкиргъэн	 э п к и р _ к _ э _ в ъ и г _ ъ _ и _ ы н ы _ кит _ н _  ъ ы _  п к и р _  г ъ э _ н _ 
ӄырым нъывъигъэн этынва пынԓёнэн	 ӄ ы р ы м _ н _  ъ ы в ъ и _  г ъ э _ н _ э т ы н в а _ п ы н ԓ ё _  н э н _ 
эӈэӈыԓьэ ивнин этынва пынԓёнэн	 э ӈ э ӈ ы _  ԓ ь _ э _ и в _ ни _ н _ э т ы н в а _ п ы н ԓ ё _  н э н _ 
эӈэӈыԓьын иквъи ыныкит энамынгыкватка ринэнтыӈ нэмэ ӄоԓ	 э ӈ э ӈ ы _ ԓьы _ н _ и к _ въ _ и _ ы н ы _ кит _ э н а _  м ы н _  г ы к в а т к а _ р и н э _  н т ы _  ӈ _ н э м э _ ӄ о ԓ _ 
рэвъигъэ экык	 р э в ъ и _ гъ _ э _ э к ы к _ 
этынва ивнин мынгыкво йыԓнинэт мытԓыӈэн ӄорат	 э т ы н в а _ и в _ ни _ н _ м ы н _  г ы к в _  о _ й ы ԓ _ ни _  н э _ т _ м ы т _  ԓ ы ӈ э н _ ӄ о р а _ т _ 
ӈирэӄ ыттъыт ӈыроӄ	 ӈ и р э ӄ _ ы т т ъ ы _  т _ ӈ ы р о ӄ _ 
игнэԓгыт эӈэӈыԓьын рагтыгъэ нэмэ	 и г н э _  ԓ г ы т _ э ӈ э ӈ ы _ ԓьы _ н _ р а _ гты _ гъэ _ н э м э _ 
ӄоԓ экык тъыԓыӈогъэ нэмэ йыннэн эӈэӈыԓьын нэмэ	 ӄ о ԓ _ э к ы к _ т ъ ы ԓ _  ы ӈ о _ гъ _ э _ н э м э _ й ы н _  н э н _ э ӈ э ӈ ы _ ԓьы _ н _ н э м э _ 
ӄытгъи иԓьуткугъи ынкъам иквъи ӄэнамынгыкватгэ пытӄымыкыӈ мынгыкваннэн эквэтгъи	 ӄ ы т _ гъ _ и _ и ԓ ь у т к у _  г ъ _ и _ ы н к ъ а м _ и к _ въ _ и _ ӄ _  э н а _  м ы н _  г ы к в а т _  г _ э _ п ы т ӄ ы _  м ы к ы _  ӈ _ м ы н _  г ы к в а н _  н э _  н _ э к в э т _  г ъ _ и _ 
эӈэӈыԓьын ԓыгэн эквэтгъи въигъи	 э ӈ э ӈ ы _ ԓьы _ н _ ԓ ы г э н _ э к в э т _  г ъ _ и _ в ъ и г _ ъ _ и _ 
тъытԓьэн ытԓыгын	 т ъ ы т ԓ ь э _ н _ ы т ԓ ы г ы _ н _ 
иквъи эккэт	 и к _ въ _ и _ э к к э _ т _ 
тэԓпыркыт ынраӄ ӈээкык тъыԓыӈогъэ	 т э ԓ п ы _  р к ы _ т _ ы н р а _ ӄ _ ӈ э э _ кык _ т ъ ы ԓ _  ы ӈ о _ гъ _ э _ 
нэмэ	 н э м э _ 
эӈэӈыԓьын йыннэн	 э ӈ э ӈ ы _ ԓьы _ н _ й ы н _ нэн _ 
ивнин эӈэӈыԓьын	 и в _ ни _ н _ э ӈ э ӈ ы _  ԓ ь ы _ н _ 
нэмэ ӄытгъи нэмэ иԓьуткугъи	 н э м э _ ӄ ы т _ гъ _ и _ н э м э _ и ԓ ь у т к у _ гъ _ и _ 
иквъи ытԓыгэ	 и к _ въ _ и _ ы т ԓ ы г _ э _ 
ивнин этынва	 и в _ ни _ н _ э т ы н в а _ 
ивнин	 и в _ ни _ н _ 
эӈэӈыԓьын иквъи анӈэнайпыгъэ эӈэӈыԓьын	 э ӈ э ӈ ы _ ԓьы _ н _ и к _ въ _ и _ а н ӈ э н а _ йпы _  г ъ _ э _ э ӈ э ӈ ы _  ԓ ь ы _ н _ 
эквэтгъи ԓёгмынгыквата ымыԓьо ԓюӈвъитэ	 э к в э т _ гъ _ и _ ԓ ё г м ы н _  г ы к в а _  т а _ ы м ы ԓ ь о _ ԓ ю ӈ _  в ъ и т э _ 
итгъэт ынӄоры эӈэӈыԓьын эӄу нэтчын	 и т г _ ъэ _ т _ ы н ӄ о р ы _ э ӈ э ӈ ы _ ԓьы _ н _ э ӄ _ у _ н э _  т ч ы н _ 
ымыԓьо нивӄинэт	 ы м ы ԓ ь о _ н _  и в _  ӄ и н э _ т _ 
ымыԓьорык эӄу нэтчын ынӈин	 ы м ы ԓ ь о _  р ы _ к _ э ӄ _  у _ н э _  т ч ы н _ ы н ӈ и н _ 
тэԓенъепкин эӈэӈыԓьыт нырагаймычьавӈыӄэнат с ыԓвыԓю эԓек нынмыткоӄэн ипэ	 т э ԓ е н _ ъеп _ кин _ э ӈ э ӈ ы _ ԓьы _  т _ н ы _  р а _  г _  а й м ы _  ч ь а в _  ӈ ы _  ӄ э н а _ т _ с _ ы ԓ в ы ԓ _ ю _ э ԓ е _ к _ н ы _  н м ы _  т к о _ ӄэн _ и п э _ 
ӄоԓ итгъэт увиԓьэтгъэт ыԓвытъуԓе	 ӄ о ԓ _ и т г _ ъэ _ т _ у в и ԓ ь э т _  г ъ э _ т _ ы ԓ в ы _  т ъ у _  ԓ е _ 
ԓыгэн ынкы напэԓянат уӄӄэмчыку эръэйыръын ынкъам	 ԓ ы г э н _ ы н _ кы _ н а _ пэԓя _  н а _ т _ у ӄ ӄ э м _  ч ы к у _ э р ъ э _  й ы р ъ ы _ н _ ы н к ъ а м _ 
ыпаԓгын эвын	 ы п а ԓ г ы _ н _ э в ы н _ 
етгъэт рэӄэ	 е т _  г ъ э _ т _ р э ӄ _ э _ 
ыпаԓгын гаткоӈӈоԓен ымы эръэт гэтъэттывиԓинэт ӄоԓ	 ы п а ԓ г ы _ н _ г а _  т к о _ ӈӈо _ ԓен _ ы м ы _ э р ъ э _ т _ г э _  т ъ э т _ т _  ы в и ԓ и н э _ т _ ӄ о ԓ _ 
ынээԓьын иквъи кита	 ы н э э ԓ ь ы _ н _ и к _ въ _ и _ к и т а _ 
ӄоԓ чайвыткоӈӈок ныпэԓятын	 ӄ о ԓ _ ч а й в ы _ тко _ ӈӈо _  к _ н ы _  п э ԓ я _  т ы _  н _ 
атав гынрыру мыныԓгын	 а т а в _ г ы н р ы р у _ м ы н ы _ ԓгы _  н _ 
ръэнут	 р ъ э н у т _ 
рэркын мури амӄынӈыток	 р э _  р к ы н _ м у р и _ а м _  ӄ ы н ӈ ы т о _  к _ 
ымыԓьо ыԓвэгиԓигъэт ӈыраӄав пэԓятгъэ ынанӈэнчьан	 ы м ы ԓ ь о _ ы ԓ в э _  г и ԓ и _  г ъ э _  т _ ӈ ы р а ӄ а в _ п э ԓ я _  т _ гъэ _ ы н а н ӈ э н _ чьа _ н _ 
пэԓятыйгот нэнтын тытԓык атчыгъэ ынӄэн оравэтԓьан	 п э ԓ я _  т ы _  й г о т _ н э _ нты _  н _ т ы т ԓ ы _ к _ а т ч ы _ гъэ _ ы н ӄ э н _ о р а в э т ԓ ь а _ н _ 
эвын амгынотъыԓё нынъэԓӄин	 э в ы н _ а м _  г ы н о т _ ъыԓё _ н ы _  н ъ э ԓ _ ӄин _ 
ԓюур	 ԓ ю у р _ 
ранмэйпык	 р а _  н _  м э й п ы _  к _ 
вииԓетгъи ԓыгэн ынкы	 в и и ԓ _  е т _  г ъ _ и _ ԓ ы г э н _ ы н _ кы _ 
эӄуԓикэ нъатчаӄэн эмӄэԓеԓвынэ нивӄин вэчьым	 э ӄ у ԓ и _ к _ э _ н _  ъ а т ч а _ ӄэн _ э м _ ӄэԓеԓвы _ н _ э _ н _ ив _ ӄин _ в э ч _ ьым _ 
ӈотӄэн ныетӄин эвын	 ӈ о т _  ӄ э н _ н ы _  е т _ ӄин _ э в ы н _ 
рэгъи	 р э _  г ъ _ и _ 
таӈамъыттъымъеквэйӈын ӈэвъэнйыръын авэтываӄ ӄԓявыԓя пэнрынэн аны энмэн гэтэйкэвԓинэт ԓюур амъыттъымъеквэйӈа	 т а ӈ _ ам _  ъ ы т т _ ъым _  ъ _  е к в э _  й ӈ ы _ н _ ӈ э в ъ э н _  й ы р ъ ы _ н _ а в э т ы _ ваӄ _ ӄ ԓ я в ы ԓ _  я _ п э н р ы _  н э н _ а н ы _ э н м э н _ г э _  т э й к э в _  ԓ и н э _ т _ ԓ ю у р _ а м _  ъ ы т т _ ъым _  ъ _  е к в э _  й ӈ а _ 
авынтайкавэты ивнин йъарат	 а в ы н _  т а й к а в _  э т ы _ и в _ ни _ н _ й ъ а _ ра _ т _ 
амӄԓявыԓторэ варкынэтык	 а м _  ӄ ԓ я в ы _  ԓ т о _  р э _ в а _  р к ы н э _  т ы к _ 
яйвачгыргыторэ	 я й в а ч _ гыргы _  т о р э _ 
вэԓерым	 в э ԓ е _  р ы м _ 
ваӈэԓьо митыркын аны энмэн оравэтԓьаӄай	 в а ӈ э _  ԓ ь о _ м и т ы _  р к ы н _ а н ы _ э н м э н _ о р а в э т ԓ ь а _  ӄ а й _ 
гувиԓьэтԓин амъыттъымъеквэйӈын тыргэтъюунин гыргоча	 г _  у в и _  ԓ ь э т _ ԓин _ а м _  ъ ы т т _ ъым _  ъ _  е к в э _  й ӈ ы _ н _ т ы р г э _  т ъ ю у _  н и _ н _ г ы р г о ч а _ 
ыпаԓга	 ы п а ԓ г а _ 
энайпаннэн ынӄо иквъи	 э н а _  й п а н _ нэ _  н _ ы н ӄ о _ и к _ въ _ и _ 
ӈэвъэнйыръын тагам ораӈанӄо ӄыԓиги ԓыганԓыгъэ	 ӈ э в ъ э н _  й ы р ъ ы _ н _ т а г а м _ о р а _  ӈ а н _  ӄ о _ ӄ ы _  ԓ и г и _ ԓ ы г а н ԓ ы _  г ъ э _ 
оравэтԓьан 	 о р а в э т ԓ ь а _ н _ _ 
ӈэвъэнйыръэ ивнин эвын	 ӈ э в ъ э н _  й ы р ъ _ э _ и в _ ни _ н _ э в ы н _ 
гитэнин 	 г и _  т э _  н и _ н _ _ 
йыӄӄайъым ӈэвъэнйыръын ынкы	 й ы ӄ _  ӄ а й _  ъ ы м _ ӈ э в ъ э н _ йыръы _ н _ ы н _ кы _ 
гитэнин оравэтԓьата	 г и _  т э _  н и _ н _ о р а в э т ԓ ь а _  т а _ 
ивнин матанэн еп чейвыткуԓьыт	 и в _ ни _ н _ м а т а _  н э _ н _ е п _ ч е й в ы _ тку _  ԓ ь ы _  т _ 
эпкиркэ увиԓьэтгъи ӈэвъэнйыръын	 э п к и р _ к _ э _ у в и ԓ ь э т _ гъ _ и _ ӈ э в ъ э н _  й ы р ъ ы _ н _ 
ԓюур пыкиргъэт ӈыроргарэ ӈытогъэ	 ԓ ю у р _ п ы к и р _  г ъ э _ т _ ӈ ы р о р г а _ рэ _ ӈ ы т о _ гъ _ э _ 
ӈэвъэнйыръын ԓыгэкоргаквъат ынинэԓьыт рэгъэт чоттагнэты	 ӈ э в ъ э н _  й ы р ъ ы _ н _ ԓ ы г э _  к о р г а к _  в ъ а _  т _ ы н и н э _ ԓьы _  т _ р э _  г ъ э _ т _ ч о т _  т а г н _ эты _ 
ынанынпычьа матанэн	 ы н а н ы н п ы _ чь _ а _ м а т а _  н э _ н _ 
ӄоԓ анӈэнайпыгъэ	 ӄ о ԓ _ а н ӈ э н а _  й п ы _ гъ _ э _ 
инэԓьуԓьын чейвыткугъэт	 и н э _  ԓ ь у _  ԓ ь ы _ н _ ч е й в ы _ тку _  г ъ э _ т _ 
нэмэ ӈыроргарэ	 н э м э _ ӈ ы р о р г а _ рэ _ 
ӄоԓ пэԓятгъэ ёрочыко нъэптыӄин ӈэвъэнйыръын	 ӄ о ԓ _ п э ԓ я _  т _ гъэ _ ё р о _  ч ы к о _ н _  ъ э п _ ты _  ӄ и н _ ӈ э в ъ э н _  й ы р ъ ы _ н _ 
ӄԓявыԓ рэсӄиквъи	 ӄ ԓ я в ы ԓ _ р э с _ ӄ _ ик _ въ _ и _ 
ивнин вынэ	 и в _ ни _ н _ в ы н э _ 
ӄырым эԓгыӄай эйминнин	 ӄ ы р ы м _ э ԓ г ы _  ӄ а й _ э й м и н _ ни _ н _ 
чит выԓгыпыркынэн ԓюур	 ч и т _ в ы ԓ г ы _ пыркынэ _ н _ ԓ ю у р _ 
вытры иргъи оравэтԓьан тымнэн ӄытԓыги эӄыԓпэ нэԓгычыку рычымӄэннин кыԓтынин майык	 в ы т р ы _ и р _ гъ _ и _ о р а в э т ԓ ь а _ н _ т ы м _ нэн _ ӄ ы т ԓ ы г и _ э ӄ ы ԓ п э _ н _  э ԓ г ы _  ч ы к у _ р ы _  ч ы м _  ӄ э н _  н и _ н _ к ы ԓ т ы _  н и н _ м а й ы к _ 
рыннин чейвыткуԓьыт етгъэт	 р ы н _ нин _ ч е й в ы _ тку _  ԓ ь ы _  т _ е т _  г ъ э _ т _ 
ӈэвъэнйыръын никвъэн	 ӈ э в ъ э н _  й ы р ъ ы _ н _ н _  и к _ въэ _ н _ 
ӈэвысӄэтэ ивнинэт	 ӈ э в ы с ӄ э т _  э _ ив _ ни _  н э _ т _ 
ынръам ӄоԓ пэԓятгъэ ынанынпычьын майгэӈкы	 ы н р ъ а м _ ӄ о ԓ _ п э ԓ я _  т _ гъэ _ ы н а н ы н п ы _ чьы _ н _ м а й _  г э ӈ _ кы _ 
ныгатгаткоӄэн ԓюур	 ны _  г а т г а _ тко _ ӄэн _ ԓ ю у р _ 
ԓявтэты ръэнут эрэтгъи маԓенэн эвыр	 ԓ я в т _  э т ы _ р ъ э н у т _ э р э т _ гъ _ и _ м а ԓ е н _ эн _ э в ы р _ 
гитэнин мутԓымуԓ иквъи эмӄэԓеԓвынэ	 г и _  т э _  н и _ н _ м у т ԓ ы _ муԓ _ и к _ въ _ и _ э м _  ӄ э ԓ е ԓ в ы _ н _ э _ 
ынръам ръэнут нэмэ	 ы н р ъ а м _ р ъ э н у т _ н э м э _ 
гатгаткоӈӈогъэ нэмэ йиннин мутԓе ӄынвэр	 г а _  т г а _ тко _ ӈӈо _  г ъ _ э _ н э м э _ й и н _  н и _ н _ м у т _ ԓе _ ӄ ы н в э р _ 
наԓгымай рырыткунин 	 н а _  ԓ г ы м _  а _  й _ р ы р ы _ тку _ ни _ н _ _ 
эвын ынкы ԓьунин ыргин ытԓеӈи ӄытԓыги	 э в ы н _ ы н _ кы _ ԓ ь у _ ни _ н _ ы р г и н _ ы т ԓ е _ ӈи _ ӄ ы т ԓ ы г и _ 
ӈавъанйыръиӈа ганмыԓен ԓыгэн авъеткынка нэмэ	 ӈ а в ъ а н _  й ы р ъ _  и _  ӈ а _ г а _  н м ы _ ԓен _ ԓ ы г э н _ а в ъ е _ ткын _ к _ а _ н э м э _ 
румэкэвнин	 р у м э к _ эв _ ни _ н _ 
ӄутти	 ӄ у т _ ти _ 
ытԓенъют етгъэт 	 ы т ԓ е н _ ъют _ е т _  г ъ э _  т _ _ 
винвэ ивнинэт	 в и н в э _ и в _ ни _  н э _ т _ 
ынӄо эргатык ымыԓьо чейвыткугъэт нутэк	 ы н ӄ о _ э р г _ атык _ ы м ы ԓ ь о _ ч е й в ы _ тку _  г ъ э _ т _ н у т э _  к _ 
увэрайӈын	 у в э р а _  й ӈ ы _ н _ 
нэтэйкын	 н э _  т э й к ы н _ 
аны таӈымъыԓёӈэт гэкымъыгичиԓинэт ԓыгэн	 а н ы _ т а ӈ _  ы м _ ъыԓё _ ӈэт _ г э _  к ы м ъ ы _  г и ч и _  ԓ и н э _ т _ ԓ ы г э н _ 
увэрайӈык ныёԓьатӄэнат ӄынвэр ыттъымиԓ майӈаӈӈогъат кымъыгинив нэтэйкын аны таӈымъыԓёӈэт	 у в э р а _  й ӈ ы _  к _ н ы _  ё _  ԓ ь а т _  ӄ э н а _ т _ ӄ ы н в э р _ ы т т ъ ы _  м и ԓ _ м а й ӈ а _ ӈӈо _  г ъ а _ т _ к ы м ъ ы г и _  н _  и в _ н э _  т э й к ы н _ а н ы _ т а ӈ _  ы м _ ъыԓё _ ӈэт _ 
гэкымъыгичиԓинэт	 г э _  к ы м ъ ы _  г и ч и _  ԓ и н э _ т _ 
ԓыгэн увэрайӈык ныёԓьатӄэнат ӄынвэр ыттъымиԓ майӈаӈӈогъат	 ԓ ы г э н _ у в э р а _  й ӈ ы _  к _ н ы _  ё _  ԓ ь а т _  ӄ э н а _ т _ ӄ ы н в э р _ ы т т ъ ы _  м и ԓ _ м а й ӈ а _ ӈӈо _  г ъ а _ т _ 
кымъыгинив ынӄо эргатык ӈэвъэнйыръын нываӈэӄэн чотыткынык	 к ы м ъ ы г и _  н _  и в _ ы н ӄ о _ э р г _ атык _ ӈ э в ъ э н _  й ы р ъ ы _ н _ н ы _  в а ӈ э _ ӄэн _ ч о т ы _ ткыны _ к _ 
ԓюур кагынмыткыната ӄочеԓгыԓгыӄай ԓьунин ӈэвъэнйыръын иквъи	 ԓ ю у р _ к а г ы н м ы _  т к ы н _  а т а _ ӄ о ч е _  ԓ г ы _  ԓ г ы _  ӄ а й _ ԓ ь у _ ни _ н _ ӈ э в ъ э н _  й ы р ъ ы _ н _ и к _ въ _ и _ 
ӄочеԓгыԓгыӄай ԓюур иквъи ивкэ ӄун миквыт	 ӄ о ч е _  ԓ г ы _  ԓ г ы _  ӄ а й _ ԓ ю у р _ и к _ въ _ и _ и в _  к _ э _ ӄ у н _ м и к _  в ы т _ 
 гыныкы нэтэйкын	 _ г ы н ы _  к ы _ н э _  т э й к ы н _ 
нутэк увэрайӈын ӄэгԓын эргатык чайвытконвэпы	 н у т э _  к _ у в э р а _  й ӈ ы _ н _ ӄ э г ԓ ы _  н _ э р г _  а т ы к _ ч а й в ы _ тко _  н _ вэпы _ 
етык никвъэн ӈэвысӄэтэ ивнинэт виин ӈотӄэнат чемынгыт ӄынчичьэркыниткы кэргымма	 е т ы _  к _ н _  и к _ въэ _ н _ ӈ э в ы с ӄ э т _  э _ и в _ ни _  н э _ т _ в и и н _ ӈ о т _  ӄ э н а _  т _ ч е м ы н _ гыт _ ӄ ы н ч и _  ч ь э _  р к ы н и _  т к ы _ к э р г _ ымм _ а _ 
ԓюур эвыр нэгитэн гагыргоԓятԓен нырэпириӈӄин	 ԓ ю у р _ э в ы р _ н э _  г и т э _  н _ г а _  г ы р г о ԓ я _ т _ ԓен _ н ы _  р э _  п и р и ӈ _ ӄин _ 
 ныԓвавӄэн пирик гыргоԓятгъэ	 _ н ы _  ԓ в а в _  ӄ э н _ п и р и _  к _ г ы р г о ԓ я _  т _  г ъ э _ 
ӄытԓыги ӄучиԓгыӄэе	 ӄ ы т ԓ ы г и _ ӄ у ч _  и ԓ г ы _  ӄ э е _ 
гангыргоԓявԓен ныпичгыӄин вэгрэтэм	 г а _  н г ы р г о ԓ я в _  ԓ е н _ ны _  п и ч г ы _ ӄин _ в э г р э т _  э м _ 
с ганымыԓьавԓен нынну ынкы вэгрэтэм	 с _ г а _  н ы м ы ԓ ь а _  в _ ԓен _ н ы н н у _ ы н _ кы _ в э г р э т _  э м _ 
аны ытԓён таӈвэнъым ныпичгыӄин	 а н ы _ ы т ԓ ё н _ т а ӈ _  в э н _ ъым _ н ы _  п и ч г ы _ ӄин _ 
тэӈпэнин ӄонратваԓьын ымыӈ	 т э ӈ _  п э н _ ин _ ӄ о н _  р а _  т в а _  ԓ ь ы _ н _ ы м ы _  ӈ _ 
нымным ванэван чымче	 н ы м н ы м _ в а н э в а н _ ч ы м ч _ е _ 
нытван миӈкыри	 ны _  т в а _  н _ м и ӈ _ кы _ ри _ 
ӄун найыԓгавӄэн	 ӄ у н _ н а _  й ы ԓ _  г а в _  ӄ э н _ 
рэԓӄынӈыт мэӈӄокэнат	 р э ԓ ӄ ы н ӈ ы _  т _ м э ӈ _  ӄ о _ кэна _  т _ 
рэмкыԓьыт кытамчачва	 р э м к ы _  ԓ ь ы _  т _ к ы т а _  м ч а ч в а _ 
ынкъам ынӄэната	 ы н к ъ а м _ ы н ӄ э н а _ та _ 
найыԓгавӄэн наӄам ытԓён ԓымыԓьын ӈирэнӈэвыԓьын	 н а _  й ы ԓ _ гав _  ӄ э н _ н а ӄ а м _ ы т ԓ ё н _ ԓ ы м ы ԓ ь ы _ н _ ӈ и р э _  н ӈ э в ы _  ԓ ь ы _ н _ 
ытԓён еп	 ы т ԓ ё н _ е п _ 
ԓыгэн аатчек	 ԓ ы г э н _ а а т ч е _  к _ 
эквыргъам ԓыгэн гэԓеԓютԓин	 э к в ы р _ гъа _ м _ ԓ ы г э н _ г э _  ԓ е ԓ _  ю т _  ԓ и н _ 
эвын ԓыгэн гэмэчынпэвыԓгэтԓин	 э в ы н _ ԓ ы г э н _ г э _  м э ч ы н п э в ы _  ԓ г э т _ ԓин _ 
ӄуԓитгивик ӄоԓ	 ӄ у ԓ и т _ гиви _ к _ ӄ о ԓ _ 
ӈэвъэн рыԓейвынин ӄаагты ынкы	 ӈ э в ъ э _ н _ р ы _  ԓ е й в ы _  н и н _ ӄ а а _  г т ы _ ы н _ кы _ 
эвын гагроръоԓен ӄаат эвын	 э в ы н _ г а _  г р о _  р ъ о _  ԓ е н _ ӄ а а т _ э в ы н _ 
ныгръоӄэнат	 ны _  г _  р ъ о _  ӄ э н а _ т _ 
ӈэнку ӄаатагнык	 ӈ э н _ ку _ ӄ а а т а г н ы _ к _ 
гытгык ӄача пэнъёԓгын нэтэйкын наӄам ӈэйгиӈкы нытваӄэн	 г ы т г ы _  к _ ӄача _ п э н ъ ё ԓ г ы _ н _ н э _  т э й к ы н _ н а ӄ а м _ ӈ э й _  г и ӈ _ кы _ н ы _ тва _ ӄэн _ 
эвыр	 э в ы р _ 
ӈэԓвыԓ гытоԓыӈкы	 ӈ э ԓ в ы ԓ _ г ы т о ԓ ы ӈ _ кы _ 
нытваӄэн тэкэм	 ны _  т в а _ ӄэн _ т э к _ эм _ 
пэтыкэԓвайынвык увэмгогъат	 п э т ы _  к э ԓ в а _  й ы н в ы _  к _ у в э м г о _  г ъ а _ т _ 
ынкы пэтыраԓӄаӈынвык	 ы н _ кы _ п э т ы _  р а ԓ _  ӄ а _  ӈ ы н в ы _ к _ 
пэтырытын ныԓгинымкыӄин	 п э т ы _  р ы т ы _  н _ н ы _  ԓ г и _ ны _ мкы _ ӄин _ 
нарычгытваӄэн ывэӄуч	 н _  а р ы ч г ы _ тва _ ӄэн _ ы в э ӄ у ч _ 
ӈэвъэным нувиӄин ынӄо мачгыргоԓягты ӈэвысӄэт уӈэԓгъи ынкы ууркиткугъи	 ӈ э в ъ э _  н ы м _ н _  у в и _ ӄин _ ы н ӄ о _ м а ч _  г ы р г о ԓ я _ гты _ ӈ э в ы с ӄ э т _ у ӈ э ԓ _ гъ _ и _ ы н _ кы _ у у р к и _  т к у _  г ъ _ и _ 
ӈэвысӄэт ынӄо	 ӈ э в ы с ӄ э т _ ы н ӄ о _ 
ываӄочегты ӄытгъи эвтыԓягты нэмэым ӈан нунрэпэтӄин тыԓяма	 ы в а ӄ о ч е _ гты _ ӄ ы т _ гъ _ и _ э в т ы ԓ я _ гты _ н э м э ы м _ ӈ а н _ н у н _  р э п э т _  ӄ и н _ т ы ԓ я _ ма _ 
наӄам нъэӄэгнитӄин ԓюур вай авынтыԓяма гыткаӄач ԓыгэгтонрапатгъэ ынраӄ	 н а ӄ а м _ н _  ъ э ӄ э г _ н _  и т _ ӄин _ ԓ ю у р _ в а й _ а в ы н т ы ԓ я _  м а _ г ы т к а _  ӄ а ч _ ԓ ы г э _  г т о _  н _  р а _  п а т _  г ъ э _ ы н р а _ ӄ _ 
тиӈук нэнаԓвавӄэн наӄам рай ынкэчыку нинэԓгийгуткуйвыӄин	 т _  и ӈ у к _ н _  э н а _  ԓ в а в _  ӄ э н _ н а ӄ а м _ р а й _ ы н к э _  ч ы к у _ н _ инэ _  ԓ г и _  й г у _  т к у _  й в ы _  ӄ и н _ 
гыткаԓгын рэӄэ ӄынвэр тиӈунин	 г ы т к а _  ԓ г ы _  н _ р э ӄ _  э _ ӄ ы н в э р _ т _  и ӈ у _ ни _ н _ 
гыткаӄач эвын ынкы рээн йытонэн ыԓчыкойпы кайӈиӈын	 г ы т к а _  ӄ а ч _ э в ы н _ ы н _ кы _ р э э н _ й ы т о _ нэ _ н _ ы ԓ ч ы к о _  й п ы _ к а й ӈ _ иӈы _ н _ 
ԓыгэн ынӄэн гыткак рээн йытонэн ыныкит гитэнин	 ԓ ы г э н _ ы н ӄ э н _ г ы т к а _ к _ р э э н _ й ы т о _ нэ _  н _ ы н ы _ кит _ г и _  т э _ ни _ н _ 
ӈэвысӄэтэ аны гэԓгигынтэвԓин ораываӄочеӈӄачагты наӄам ныԓгиӄуԓиԓьэтӄин аны	 ӈ э в ы с ӄ э т _  э _ а н ы _ г э _ ԓги _  г ы н т э в _ ԓин _ о р а ы _  в а ӄ о _  ч е _  ӈ ӄ а ч а _  г т ы _ н а ӄ а м _ н ы _ ԓги _  ӄ у ԓ и _ ԓьэт _ ӄин _ а н ы _ 
вай ръанотайӈоон нэмэым ӈан	 в а й _ р ъ а н о _  т а й ӈ о о н _ н э м э ы м _ ӈ а н _ 
нунрэпэтӄин тыԓяма наӄам	 н у н _  р э п э т _  ӄ и н _ т ы ԓ я _ ма _ н а ӄ а м _ 
нъэӄэгнитӄин ԓюур вай	 н _  ъ э ӄ э г _ н _  и т _ ӄин _ ԓ ю у р _ в а й _ 
авынтыԓяма гыткаӄач	 а в ы н т ы ԓ я _  м а _ г ы т к а _  ӄ а ч _ 
ԓыгэгтонрапатгъэ ынраӄ тиӈук	 ԓ ы г э _  г т о _  н _  р а _  п а т _  г ъ _ э _ ы н р а _ ӄ _ т _  и ӈ у к _ 
нэнаԓвавӄэн наӄам рай ынкэчыку	 н _  э н а _  ԓ в а в _  ӄ э н _ н а ӄ а м _ р а й _ ы н к э _  ч ы к у _ 
нинэԓгийгуткуйвыӄин гыткаԓгын рэӄэ	 н _ инэ _  ԓ г и _  й г у _  т к у _  й в ы _  ӄ и н _ г ы т к а _  ԓ г ы _  н _ р э ӄ _  э _ 
ӄынвэр тиӈунин	 ӄ ы н в э р _ т _  и ӈ у _ ни _ н _ 
гыткаӄач	 г ы т к а _  ӄ а ч _ 
 эвын ынкы	 _ э в ы н _ ы н _ кы _ 
рээн	 р э э н _ 
йытонэн ыԓчыкойпы кайӈиӈын ԓыгэн	 й ы т о _ нэ _ н _ ы ԓ ч ы к о _  й п ы _ к а й ӈ _ иӈы _ н _ ԓ ы г э н _ 
ынӄэн гыткак	 ы н ӄ э н _ г ы т к а _  к _ 
рээн йытонэн ыныкит гитэнин ӈэвысӄэтэ аны гэԓгигынтэвԓин ораываӄочеӈӄачагты	 р э э н _ й ы т о _ нэ _  н _ ы н ы _ кит _ г и _  т э _ ни _ н _ ӈ э в ы с ӄ э т _  э _ а н ы _ г э _ ԓги _  г ы н т э в _ ԓин _ о р а ы _  в а ӄ о _  ч е _  ӈ ӄ а ч а _  г т ы _ 
наӄам ныԓгиӄуԓиԓьэтӄин аны вай ръанотайӈоон	 н а ӄ а м _ н ы _ ԓги _  ӄ у ԓ и _ ԓьэт _ ӄин _ а н ы _ в а й _ р ъ а н о _  т а й ӈ о о н _ 
ӄынвэр ӈан тэӈынпунӈитэвнин кэйӈын	 ӄ ы н в э р _ ӈ а н _ т э ӈ _  ы н п у н _  ӈ и т э в _  н и _ н _ к э й ӈ ы _ н _ 
гынтавычгатгъэ	 г ы н т а в ы _  ч г _ ат _ гъэ _ 
кайӈиӈын рагтыгъат	 к а й ӈ _ иӈы _ н _ р а _  г т ы _ гъа _ т _ 
ытри ынӄо нэмэ эԓеръугъи тыԓванымтакачгыка	 ы т р и _ ы н ӄ о _ н э м э _ э ԓ е _  р ъ у _ гъ _ и _ т ы ԓ в а _  н ы м т а к а ч _ гы _  к _ а _ 
ынръа гатваԓен	 ы н р ъ а _ г а _  т в а _ ԓен _ 
ӄоныръым эвын ынӈин эмӄынгивик анымтакачгыка	 ӄ о н ы _ р _ ъым _ э в ы н _ ы н ӈ и н _ э м ӄ ы н г и в и _ к _ а н ы м т а к а ч _  г ы _  к _  а _ 
нытваӄэн вэгрэтэм	 ны _  т в а _ ӄэн _ в э г р э т _  э м _ 
таӈымыԓьо вээм	 т а ӈ _  ы м ы ԓ ь о _ в э э м _ 
ръиԓеръугъи кыткытръогъэ аноԓьатынвык	 р ъ и ԓ е _  р ъ у _ гъ _ и _ к ы т к ы т _ ръо _  г ъ _ э _ а н о ԓ ь _  а т ы н в ы _ к _ 
тыԓегъи вэгрэтэм	 т ы ԓ е _  г ъ _ и _ в э г р э т _  э м _ 
ӄаанматыԓьатгъэ ынӄо имтиԓӄытгъи ӄааԓьатакватгъэ	 ӄ а а н _ маты _  ԓ ь а т _ гъ _ э _ ы н ӄ о _ и м т _  и ԓ ӄ ы т _ гъ _  и _ ӄ а а ԓ ь а _  т _  а к в а т _ гъэ _ 
тыԓвамыргынан	 т ы ԓ в а _  м ы р г ы _ нан _ 
ӈэвъэнти пэԓянэнат наӄам	 ӈ э в ъ э н _  т и _ п э ԓ я _  н э _ на _ т _ н а ӄ а м _ 
ӄоԓ	 ӄ о ԓ _ 
ӈэвъэн нанӄыԓьын нынныӈыттыӄинэт	 ӈ э в ъ э _ н _ н _  а н ӄ ы _  ԓ ь ы _ н _ н ы н н ы _  ӈ ы т т ы _  ӄ и н э _ т _ 
эԓеӈит юур	 э ԓ е _  ӈ и т _ ю у р _ 
рай ӄуԓиныкитэ	 р а й _ ӄ у ԓ и _  н ы _  к и т _ э _ 
мэԓӄэпы ръэнут нывыргыргыръуӄин наӄам мэԓӄыткынык таӈвэнъым	 м э ԓ ӄ _  э п ы _ р ъ э н у т _ н ы _  в ы р г ы р г ы _  р ъ у _  ӄ и н _ н а ӄ а м _ м э ԓ ӄ ы _  т к ы н ы _ к _ т а ӈ _  в э н _ ъым _ 
мыгтэкичгыԓьын ынӄо эргатръогъэ нэгитэнэт тэкичгыт	 м ы г _ тэкичгы _ ԓьы _  н _ ы н ӄ о _ э р г _  а т _ ръо _  г ъ _ э _ н э _  г и т э _  н э _ т _ т э к и ч _  г ы т _ 
аны эвын гэԓгинуйвыԓинэт	 а н ы _ э в ы н _ г э _ ԓги _  н у _  й в ы _  ԓ и н э _ т _ 
тэкичгыт ынӄо нэмэ	 т э к и ч _ гыт _ ы н ӄ о _ н э м э _ 
йыԓӄэтгъэт ӄуԓивуԓӄытвик кыеквъэт	 й ы ԓ ӄ _ эт _  г ъ э _ т _ ӄ у ԓ _ иву _ ԓӄы _ тви _ к _ к ы е к _  в ъ э _ т _ 
 эвын тэӈуйӈэ	 _ э в ы н _ т э ӈ _  у й ӈ э _ 
тэкичгыт миԓӄык таӈымыԓьо гэнуйвыԓинэт аны ныԓгайыԓгавӄэнат ӄуԓиныкитэ	 т э к и ч _ гыт _ м и ԓ ӄ ы к _ т а ӈ _  ы м ы ԓ ь о _ г э _  н у _  й в ы _ ԓинэ _ т _ а н ы _ н ы _  ԓ г а _  й ы ԓ _ гав _  ӄ э н а _ т _ ӄ у ԓ и _  н ы _  к и т _ э _ 
яракэн рэнмырэм	 я р а _  к э н _ р э н _  м ы р э м _ 
натъайытчагъан	 н а т ъ а й ы т ч а _  г ъ а _  н _ 
ԓыгэн нынӄъэӄыръувӄин ӄытԓыги	 ԓ ы г э н _ н ы _  н _  ӄ ъ э ӄ ы р ъ у в _  ӄ и н _ ӄ ы т ԓ ы г и _ 
ынӄэнат кэйӈыт	 ы н ӄ э н а _  т _ к э й ӈ ы _  т _ 
амайыԓгаым ванэван нырэӄынэт ӈэвысӄэтти ӄынвэр ӄоԓетъыԓё тэӈэтэкичгыкэ нъэԓгъэт таӈымыԓьо гагтоԓенат кэйӈэ	 а м _  а й ы ԓ _  г а ы м _ в а н э в а н _ ны _  р э ӄ ы _  н э _ т _ ӈ э в ы с ӄ э т _ ти _ ӄ ы н в э р _ ӄ о ԓ е _ тъыԓё _ т э ӈ _  э т _  э к и ч _ гы _ к _ э _ н _  ъ э ԓ _  г ъ э _ т _ т а ӈ _ ымыԓьо _ г а _  г т о _  ԓ е н а _ т _ к э й ӈ э _ 
ӄуԓивуԓӄытвик энарэрыԓьатыӈӈогъат рэноԓгыгэӈгыпы ԓыгэн	 ӄ у ԓ _ иву _ ԓӄы _ тви _ к _ э н а р э р ы _  ԓ ь _  а т ы _  ӈ ӈ о _  г ъ а _  т _ р э н о ԓ г ы _  г э ӈ _  г ы п ы _ ԓ ы г э н _ 
ӄун	 ӄ у н _ 
ныԓгивэгыткуԓьэтӄинэт	 ны _  ԓ г и _  в э г ы _ тку _  ԓ ь э т _  ӄ и н э _ т _ 
уйӈэ нытваӄэнат	 у й ӈ э _ н ы _  т в а _  ӄ э н а _ т _ 
ԓюур	 ԓ ю у р _ 
ӄотԓяйӈын ёрогты	 ӄ о т ԓ я _ йӈы _ н _ ё р о _  г т ы _ 
кытгъи ерочыкон нэнчимиръэвын нанӄыԓьын нэпиригъэн ынӄо таӈавынӄоԓеԓьыръогты	 к ы т г _ ъ _ и _ е р о _  ч ы к о _  н _ н э _  н _  ч и м и _  р ъ _  э в ы _ н _ н _  а н ӄ ы _  ԓ ь ы _ н _ н э _  п и р и _ гъэ _ н _ ы н ӄ о _ т а ӈ _  а в ы _ нӄоԓе _ ԓьы _  р ъ о _  г т ы _ 
нанынтоӈатын ӈаргыногты эргатръогъэ таӈамынан нъэԓгъи чимгъугъи ӈэвысӄэт тэйкынин тытԓык ваны варэсӄыткынык	 н _  а н ы _  н т о ӈ _  а т ы _  н _ ӈ а р г ы н о _ гты _ э р г _  а т _  р ъ о _ гъ _ э _ т а ӈ _  а м _  ы н а н _ н _  ъ э ԓ _ гъ _ и _ ч и м г ъ у _  г ъ _ и _ ӈ э в ы с ӄ э т _ т э й к ы _ ни _ н _ т ы т ԓ ы _ к _ в а н ы _ в а р э _  с ӄ ы _  т к ы н ы _ к _ 
румэкэвъюунинэт уунъыкэнъут	 р у м э к _  э в ъ ю у _  н и _  н э _ т _ у у н ъ ы _  к э н ъ у _  т _ 
ӈэнку натчытваӄэн	 ӈ э н _ ку _ н _  а т ч ы _  т в а _ ӄэн _ 
вуԓӄытвигъи нэмэ ԓыгэн ярачыкогты	 в у ԓ ӄ ы _ тви _  г ъ _ и _ н э м э _ ԓ ы г э н _ я р а _  ч ы к о _ гты _ 
авынгачагъат ытԓёным	 а в ы н г а ч а _  г ъ а _ т _ ы т ԓ ё н ы м _ 
ӈоон гыргоԓ	 ӈ о о н _ г ы р г о ԓ _ 
нывакъотваӄэн нэмэ	 ны _  в а к ъ о _ тва _ ӄэн _ н э м э _ 
моогъат энарэрыԓьатык	 м о о _  г ъ а _ т _ э н а р э р ы _  ԓ ь а _  т ы к _ 
 инэԓьук ԓываквъат ӄоԓ	 _ и н э _  ԓ ь у _ к _ ԓ ы в а к _  в ъ а _  т _ ӄ о ԓ _ 
ӈытоӈӈой ӈытосӄэвыԓьын	 ӈ ы т о _  ӈ ӈ о й _ ӈ ы т о _  с ӄ э в ы _ ԓьы _ н _ 
ӈэвысӄэтэ ӈыԓенӈыԓетэ	 ӈ э в ы с ӄ э т _  э _ ӈ ы _  ԓ е н ӈ ы ԓ е _  т э _ 
инэгнэрэннин ӄаптэткынык иргъи ӈыԓенӈыԓет ԓыгэным эвыр ынкэӄэй ӈыԓетръугъи кайӈиӈын авынгынтавыԓьатэты йытрыкымгытръогъэ	 и н э _  г н э _  р э н _  н и _ н _ ӄ а п т э _  т к ы н ы _ к _ и р _ гъ _ и _ ӈ ы _  ԓ е н ӈ ы _  ԓ е т _ ԓ ы г э _ ным _ э в ы р _ ы н к э _ ӄэй _ ӈ ы ԓ е т _  р ъ у _ гъ _ и _ к а й ӈ _  и ӈ ы _ н _ а в ы н г ы н т а в ы _  ԓ ь а т _  э т ы _ й ы т р ы _  к ы м г ы т _  р ъ о _  г ъ _ э _ 
ынӄоым гапэӄэттатԓен ӄотԓяйӈаым таӈгэмо нинэԓгыӄин	 ы н ӄ о ы м _ г а _  п э ӄ э т _  т а т _ ԓен _ ӄ о т ԓ я _  й ӈ а ы м _ т а ӈ _  г э м _ о _ н _ инэ _ ԓгы _  ӄ и н _ 
тыԓвыԓьын ынин	 т ы ԓ в ы _  ԓ ь ы _ н _ ы н _  и н _ 
томгиӈын	 т о м г _  и ӈ ы _ н _ 
пԓыткугъи энарэрыԓьатык ӈытоӈӈой	 п ԓ ы т к у _  г ъ _ и _ э н а р э р ы _  ԓ ь а _  т ы к _ ӈ ы т о _  ӈ ӈ о й _ 
кайӈиӈын нэмэ рэрэннин йынйынчыӈын	 к а й ӈ _ иӈы _ н _ н э м э _ р э р э н _ ни _ н _ й ы н _  й ы н ч ы _  ӈ ы _ н _ 
рыԓвэтъюунин ӈоонко	 р ы ԓ в _  э т ъ ю у _  н и _ н _ ӈ о о н _  к о _ 
пэӄэттатгъэ	 п э ӄ э т _  т а т _ гъэ _ 
уйӈэ нъэԓгъи	 у й ӈ э _ н _  ъ э ԓ _ гъ _ и _ 
эгытԓикэйӈыкэ ӄоԓетъыԓё пыкиргъи ӄааԓьатыԓьын	 э г ы т ԓ и к э й ӈ ы _  к _  э _ ӄ о ԓ е _ тъыԓё _ п ы к и р _ гъ _ и _ ӄ а а ԓ ь а т ы _ ԓьы _ н _ 
ӈэвъэнэ ԓыгэнитык	 ӈ э в ъ э н _ э _ ԓ ы г э н и _ тык _ 
ԓыгъэйӈэчьивнин раӈӈытайым	 ԓ ы г _  ъ э й ӈ э _ чь _  и в _  н и _ н _ р а _  ӈ _ ӈыта _  й ы м _ 
эми ӄоԓ ӈэвысӄэт энмэч	 э м _  и _ ӄ о ԓ _ ӈ э в ы с ӄ э т _ э н м э ч _ 
ымыӈ гым вэнъыгну тыегтэԓык ԓыгэн аны	 ы м ы _ ӈ _ г ы м _ в э н ъ ы г _  н у _ т ы е г _  т э ԓ ы _ к _ ԓ ы г э н _ а н ы _ 
гыт мурык	 г ы т _ м у р ы _  к _ 
аӈъачгыргэгыт нымытвак	 а ӈ ъ а ч _  г ы р г _ эгыт _ н ы _  м ы т в а _  к _ 
нэмэ нымытваӈӈогъат рымагтэты гытгаръогъэ яԓгытгъат рэвиквъэт	 н э м э _ н ы _  м ы т в а _  ӈ ӈ о _ гъа _ т _ р ы _  м а г т _ эты _ г ы т г а р ъ о _ гъ _ э _ я ԓ г ы т _ гъа _ т _ р э в и к _ въэ _ т _ 
йичьэннупык ӄача ынкы	 й и ч ь э н _  н у _  п ы к _ ӄ а ч а _ ы н _ кы _ 
ынраӄ кэтэм гатваԓен пэнинэԓьын ӄԓявыԓ чама ӄэгъюргын	 ы н р а _ ӄ _ к э т э м _ г а _  т в а _ ԓен _ п э н и н э _  ԓ ь ы _  н _ ӄ ԓ я в ы ԓ _ ч а м а _ ӄ э г _  ъ ю р г ы _  н _ 
тараӈыпԓыткогъат умуттуут пиринин ӄыԓявоԓя ынкъам	 т а р а _  ӈ ы _  п ԓ ы т к о _  г ъ а _ т _ у м у т _  т у у _ т _ п и р и _ ни _ н _ ӄ ы ԓ _  я в о ԓ _  я _ ы н к ъ а м _ 
йъонэн	 й ъ о _ нэ _ н _ 
въиԓьын ынкы ытръэч нытваӄэн пыгԓыԓявыт ынӄэн кыпԓынэн рычимиръэвнин ынӄо рагтыгъэ вуԓӄытвигъи	 в ъ и ԓ ь ы _ н _ ы н _ кы _ ы т р ъ э ч _ н ы _ тва _ ӄэн _ п ы г ԓ ы ԓ _  я в ы т _ ы н ӄ э н _ к ы п ԓ ы _ нэн _ р ы ч и м и _ ръэв _ ни _ н _ ы н ӄ о _ р а _ гты _  г ъ э _ в у ԓ ӄ ы _ тви _  г ъ _ и _ 
ривыԓӄытгьи наӄамым ӈэԓвыԓ ярак камԓеԓы нытваӄэн ӈэвысӄэт амынан ярак пэԓятгъэ айвэчгыръогъэ ӈэвысӄэт ванэван ныйыԓӄэтын ԓюур	 р и в ы ԓ ӄ ы т _  г ь _ и _ н а ӄ а м ы м _ ӈ э ԓ в ы ԓ _ я р а _  к _ к а м ԓ _  е ԓ ы _ н ы _  т в а _ ӄэн _ ӈ э в ы с ӄ э т _ а м _  ы н а н _ я р а _ к _ п э ԓ я _  т _ гъэ _ а й в э ч _  г ы _  р ъ о _  г ъ _ э _ ӈ э в ы с ӄ э т _ в а н э в а н _ н ы _  й ы ԓ ӄ _  э т ы _ н _ ԓ ю у р _ 
рай ръэнут выргыргэтгъи тытԓыӄачайпы ӈэвысӄэт паԓёмтэԓгъэ нэмэ рай выргыргыръугьи яраттатгъэ ӄытԓыги рыногыргэпы	 р а й _ р ъ э н у т _ в ы р г ы р г э т _ гъ _ и _ т ы т ԓ ы ӄ а ч а _  й п ы _ ӈ э в ы с ӄ э т _ п а ԓ ё м _ тэԓ _ гъ _ э _ н э м э _ р а й _ в ы р г ы р г ы _ ръу _  г ь _ и _ я р а _  т т _  а т _  г ъ э _ ӄ ы т ԓ ы г и _ р ы н о _ гырг _  э п ы _ 
ԓевыт ръыԓинин ынӄо нывэтгавӄэн микынэ гымнин ԓевыт гэнчимиръэвԓин иԓпыгитэ	 ԓ е в ы т _ р ъ ы ԓ и _ ни _ н _ ы н ӄ о _ н ы _  в э т г а в _ ӄэн _ м и к ы _ нэ _ г ы м _  н и н _ ԓ е в ы т _ г э _  н _  ч и м и _  р ъ _  э в _ ԓин _ и ԓ п ы _  г и т э _ 
ръыԓинин увик ээ вынэ авъеткынка ӄытватык эрэтгъи рыногыргыткынгыпы	 р ъ ы ԓ и _ ни _ н _ у в и к _ э э _ в ы н э _ а в ъ е _ ткын _ к _ а _ ӄ ы _ тва _  т ы к _ э р э т _ гъ _ и _ р ы н о _  г ы р г ы _  т к ы н _ гыпы _ 
ынраӄ аграткынык иргъи эми авынраԓьын ээ	 ы н р а _ ӄ _ а г р а _  т к ы н ы _ к _ и р _ гъ _ и _ э м _ и _ а в ы н р а _  ԓ ь ы _ н _ э э _ 
уйӈэээ ээ уйӈэээ чьовыргын	 у й ӈ э э _  э _ э э _ у й ӈ э э _  э _ ч ь о _ выргы _ н _ 
рывэнтэннин ӈэвысӄэт гэԓгичеӈыттэтԓин рыпэт гэтэӈуԓвэвԓин ыннэнпэнинэк пынԓёԓьатыӈӈогъэ каԓьайӈын микынэӈ гэнчимэвԓин ээ	 р ы в э н т _ эн _ ни _ н _ ӈ э в ы с ӄ э т _ г э _  ԓ г и _  ч е ӈ ы т т э т _ ԓин _ р ы п э т _ г э _  т э ӈ _  у ԓ в _  э в _ ԓин _ ы н н э н _  п э н и н э _  к _ п ы н ԓ ё ԓ ь _ аты _  ӈ ӈ о _ гъ _ э _ к а ԓ ь а _  й ӈ ы _ н _ м и к ы _ нэ _  ӈ _ г э _  н _  ч и м э в _ ԓин _ э э _ 
вынэ ӄымӈыԓтэԓыркын ӈэвысӄэт	 в ы н э _ ӄ ы м ӈ ы ԓ _  т э ԓ ы _  р к ы н _ ӈ э в ы с ӄ э т _ 
моогъэ вэтгавык гымык ывэӄучитэ ынӈин рыннин миӈкыри ӄун ԓыгиӄэгъюргын	 м о о _ гъ _ э _ в э т г а в ы _  к _ г ы м ы _ к _ ы в э ӄ у _ чит _ э _ ы н ӈ и н _ р ы н _ нин _ м и ӈ _ кы _ ри _ ӄ у н _ ԓ ы г и ӄ э _  г ъ ю р г ы _  н _ 
гымнин ывэӄуч чама ԓыгъэткиӈ ԓыгэн	 г ы м _  н и н _ ы в э ӄ у ч _ ч а м а _ ԓ ы г _  ъ э т _  к и ӈ _ ԓ ы г э н _ 
ӄун эӄэгкутъюунин каԓьайӈын	 ӄ у н _ э _  ӄ э г к у _  т ъ ю у _  н и _ н _ к а ԓ ь а _ йӈы _ н _ 
иквъи мурык рэтэӈычьэтгъэ ынӄэн	 и к _ въ _ и _ м у р ы _ к _ р э т э ӈ ы _  ч ь _  э т _  г ъ _  э _ ы н ӄ э н _ 
ӄырымэн кэԓы въиԓьын пэнинэԓьын	 ӄ ы р ы м _  э н _ к э ԓ ы _ в ъ и ԓ ь ы _ н _ п э н и н э _  ԓ ь ы _ н _ 
ынӄо рынтоӈаннэн эргатык	 ы н ӄ о _ р ы н т о _  ӈ а н _ нэ _  н _ э р г _  а т ы к _ 
эвын эргыръоӈӈок ӄԓявыԓ рагтыгъэ амын	 э в ы н _ э р г ы _ ръо _ ӈӈо _  к _ ӄ ԓ я в ы ԓ _ р а _ гты _  г ъ э _ а м _ ын _ 
эвын уйӈэ ярак ӈэвысӄэт	 э в ы н _ у й ӈ э _ я р а _ к _ ӈ э в ы с ӄ э т _ 
ӄырирнин танԓымынӄоԓьук	 ӄ ы р и р _ ни _ н _ т а н ԓ ы м _ ынӄо _  ԓ ь у _  к _ 
ԓывавнэн ынӄо маёԓгыткынэты ӄытгъи 	 ԓ ы в а в _ нэн _ ы н ӄ о _ м а ё _ ԓгы _  т к ы н _  э т ы _ ӄ ы т _ гъ _ и _ _ 
эвын ӈэнку нарычгытваӄэн гитэнин эвын гэвъиԓин ԓюӈпиритэ ымыӈ рыннин	 э в ы н _ ӈ э н _ ку _ н _  а р ы ч г ы _ тва _ ӄэн _ г и _  т э _  н и _ н _ э в ы н _ г э _  в ъ и _ ԓин _ ԓ ю ӈ _  п и р и _ тэ _ ы м ы _  ӈ _ р ы н _ нин _ 
ԓыгэн рагтыгъэ кытгынта рырэйвэвнин яраӈы	 ԓ ы г э н _ р а _ гты _  г ъ э _ к ы т г ы н т а _ р ы _  р э й в _  э в _ ни _ н _ я р а _  ӈ ы _ 
ԓыгэӄыԓпэ ынкъам яԓгытгъэ нымгутыԓеӄин гэԓгуврэмгутыԓеԓин рэвиквъи	 ԓ ы г _  э ӄ ы ԓ п э _ ы н к ъ а м _ я ԓ г ы т _  г ъ э _ н ы м г у т ы ԓ е _  ӄ и н _ г э _  ԓ г у в р э м г у _  т ы ԓ е _ ԓин _ р э в и к _  в ъ _ и _ 
вытку воԓӄытвэма тараӈгъэ	 в ы т к у _ в о ԓ ӄ ы _ твэ _  м а _ т а р а _ ӈ _  г ъ э _ 
ԓыгэӄыԓпэ ԓыгэн	 ԓ ы г _  э ӄ ы ԓ п э _ ԓ ы г э н _ 
апԓёратвака рай	 а п ԓ ё р а _ тва _ к _ а _ р а й _ 
ӄоԓейӈын	 ӄ о ԓ е _  й ӈ ы _ н _ 
мооръэтыӈӄачайпы	 м о о _  р ъ _  э т ы _  ӈ ӄ а ч а _  й п ы _ 
вэгрэтээм эмитԓёнайгоот коԓё наӄам	 в э г р э т _  э э м _ э _  м и т ԓ ё н а _  й г о о _  т _ к о ԓ ё _ н а ӄ а м _ 
отконаӈайӈыт нынрыӄинэт пыкэрычгатгъат кынмаԓ ԓыгэн ынкы нанмын вэгрэтэм ынаным иам ныпичгыӄин с энмэн ӄоԓ	 о т к о _  н а _  ӈ а й ӈ ы _  т _ н ы _  н р ы _ ӄинэ _ т _ п ы к э р ы ч г _ ат _  г ъ а _ т _ к ы н м _ аԓ _ ԓ ы г э н _ ы н _ кы _ н а _  н м ы _  н _ в э г р э т _  э м _ ы н а н ы м _ и а м _ н ы _  п и ч г ы _ ӄин _ с _ э н м э н _ ӄ о ԓ _ 
имъэԓиԓьин ӄԓявыԓ амыным нивӄин нивӄинэт энмэн	 и м ъ э ԓ и _  ԓ ь _  и н _ ӄ ԓ я в ы ԓ _ а м _ ыным _ н _ ив _ ӄин _ н _ ив _  ӄ и н э _ т _ э н м э н _ 
ынӄэн имъэԓиԓьырык гатваԓен тэԓенъеп	 ы н ӄ э н _ и м ъ э ԓ и _  ԓ ь ы _  р ы _ к _ г а _  т в а _ ԓен _ т э ԓ е н ъ _ еп _ 
энмэн ӄоԓ имъэԓиԓьин ӄԓявыԓ	 э н м э н _ ӄ о ԓ _ и м ъ э ԓ и _  ԓ ь _  и н _ ӄ ԓ я в ы ԓ _ 
амыным нивӄин выквыԓгын ӈутку ниниԓгэтӄин ӈиԓгэ ынкъам	 а м _ ыным _ н _ ив _ ӄин _ в ы к в ы _  ԓ г ы _ н _ ӈ у т к у _ н _  и н _  и ԓ г _  э т _ ӄин _ ӈ и ԓ г _ э _ ы н к ъ а м _ 
ныриӈэӄин ыяа гыргоԓягты риӈэгъи ӄоԓетъыԓё коԓё ёо гэпкитԓин айгынԓейпы наӄам ынкэкин ымыԓьо гивиниԓинэт 	 ны _  р и ӈ э _  ӄ и н _ ы я а _ г ы р г о ԓ я _ гты _ р и ӈ э _  г ъ _ и _ ӄ о ԓ е _ тъыԓё _ к о ԓ ё _ ё о _ г э _  п к и т _ ԓин _ а й _  г ы н ԓ е _ йпы _ н а ӄ а м _ ы н _  к э _ кин _ ы м ы ԓ ь о _ г _ ив _  и н и _  ԓ и н э _ т _ _ 
гэнԓьэтэтԓинэт гэԓыткынык	 г э _  н _  ԓ ь э т _ эт _  ԓ и н э _ т _ г э _  ԓ ы т к ы н ы _ к _ 
ымыԓьо имъэԓиԓьыт ӄԓявыԓтэ ынӄо	 ы м ы ԓ ь о _ и м ъ э ԓ и _  ԓ ь ы _ т _ ӄ ԓ я в ы ԓ _  т э _ ы н ӄ о _ 
ӈырача кивкы ӄԓявыԓен нэнэны гивԓин эптэ	 ӈ ы р а _ ча _ к и в _ кы _ ӄ ԓ я в ы _  ԓ е н _ н э н э _ ны _ г _  и в _ ԓин _ э п т э _ 
гым ытԓыгмиԓ мыриӈэгъэк ытԓьата нинивӄин ынӄо гэвэнэчаԓен имъэԓиԓьын ӈинӄэй ынӄэн тъэче киквъи ёатык	 г ы м _ ы т ԓ ы г _  м и ԓ _ м ы _  р и ӈ э _  г ъ э _  к _ ы т ԓ ь а _ та _ н _  и н _ ив _ ӄин _ ы н ӄ о _ г э _  в э н э ч а _  ԓ е н _ и м ъ э ԓ и _  ԓ ь ы _ н _ ӈ и н _ ӄэй _ ы н ӄ э н _ т ъ э ч _ е _ к и к _ въ _ и _ ё а _  т ы к _ 
ярак ынӄоры ынӄэн ӈинӄэй	 я р а _ к _ ы н ӄ о р ы _ ы н ӄ э н _ ӈ и н _ ӄэй _ 
иквъи амын амморгынан мытынъэԓмык мэӈӄо мури	 и к _ въ _ и _ а м _  ы н _ а м _  м о р г ы _ нан _ м ы т ы _  н ъ э ԓ _ мык _ м э ӈ _  ӄ о _ м у р и _ 
мытраӄамэтва ԓымӈэ иквъи ытԓьата ивнин ӈинӄэй	 м ы т _  р а _  ӄ а м э т в а _ ԓ ы м _  ӈ э _ и к _ въ _ и _ ы т ԓ ь а _ та _ ив _ ни _ н _ ӈ и н _ ӄэй _ 
гивԓин ытԓьата ивнин эккэтэ ивнин	 г _  и в _ ԓин _ ы т ԓ ь а _ та _ ив _ ни _ н _ э к к э _ тэ _ ив _ ни _ н _ 
кита имъэԓиԓьын мыёпатынат аӈӄата рыԓьататъёттэ ытԓьата ивнин	 к и т а _ и м ъ э ԓ и _  ԓ ь ы _ н _ м ы ё _  п а т ы _  н а _ т _ а ӈ ӄ а _  т а _ р ы _  ԓ ь а _  т а т _  ъ ё т _ тэ _ ы т ԓ ь а _ та _ и в _ ни _ н _ 
ӈинӄэе ивнин наӄам ёо коԓё ӄынвэр ытԓьата ивнин ӈинӄэй	 ӈ и н _  ӄ э е _ и в _ ни _ н _ н а ӄ а м _ ё о _ к о ԓ ё _ ӄ ы н в э р _ ы т ԓ ь а _  т а _ и в _ ни _ н _ ӈ и н _ ӄэй _ 
иквъи эвыр трэԓьуӈын эӄыԓпэ трэетгъэ ымыԓьо	 и к _ въ _ и _ э в ы р _ т _  р э _ ԓьу _  ӈ ы _ н _ э ӄ ы ԓ п э _ т _ рэ _  е т _ гъэ _ ы м ы ԓ ь о _ 
имъэԓиԓьыт гумэкэтԓинэт нивӄинэт эквэтгъи коԓё ёо авынтыԓягты	 и м ъ э ԓ и _  ԓ ь ы _ т _ г _  у м э к _ эт _ ԓинэ _ т _ н _  и в _ ӄинэ _ т _ э к в э т _  г ъ _ и _ к о ԓ ё _ ё о _ а в ы н т ы ԓ я _ гты _ 
ӄытгъи ӄоԓ	 ӄ ы т _ гъ _ и _ ӄ о ԓ _ 
ԓьунин ӄԓявыԓ нэмыӄэй	 ԓ ь у _ ни _ н _ ӄ ԓ я в ы ԓ _ н э м ы ӄ э й _ 
риӈэԓьын ивнин ԓюур иквъи гытым нырэӄигыт имъэԓиԓьэ	 р и ӈ э _  ԓ ь ы _ н _ и в _ ни _ н _ ԓ ю у р _ и к _ въ _ и _ г ы т ы м _ н ы _  р э ӄ _ игыт _ и м ъ э ԓ и _  ԓ ь _  э _ 
ивнин уӈииԓьэ ивнин	 и в _ ни _ н _ у ӈ и и _  ԓ ь _  э _ и в _ ни _ н _ 
имъэԓиԓьэ ивнин уӈииԓьэ	 и м ъ э ԓ и _  ԓ ь _  э _ и в _ ни _ н _ у ӈ и и _  ԓ ь _  э _ 
ивнин ынӄоры ынӈин	 и в _ ни _ н _ ы н ӄ о р ы _ ы н ӈ и н _ 
вэтгавма ԓюур уӈииԓьэ кыпԓынэн аԓыгатгата имъэԓиԓьын	 в э т г а в _  м а _ ԓ ю у р _ у ӈ и и _  ԓ ь _  э _ к ы п ԓ ы _ нэн _ а ԓ ы г _  а т г _  а т а _ и м ъ э ԓ и _  ԓ ь ы _ н _ 
ԓевыт гэчвиԓин имъэԓиԓьын эрэтгьи гэԓыткынык иргъи уйӈэ эриӈэкэ нъэԓгъи	 ԓ е в ы т _ г э _  ч в и _  ԓ и н _ и м ъ э ԓ и _  ԓ ь ы _  н _ э р э т _  г ь _  и _ г э _  ԓ ы т к ы н ы _ к _ и р _ гъ _ и _ у й ӈ э _ э _  р и ӈ э _  к _ э _ н _  ъ э ԓ _ гъ _ и _ 
ынӄоры уӈииԓьэ аԓыгаттэ тиӈунин эйминнин ынӄо нымэԓьэв	 ы н ӄ о р ы _ у ӈ и и _  ԓ ь _  э _ а ԓ ы г _ ат _  т э _ т _  и ӈ у _ ни _ н _ э й м и н _ ни _ н _ ы н ӄ о _ н ы _  м э ԓ ь э в _ 
нъыркыпԓынэн	 н _  ъ ы р к ы п ԓ ы _  н э н _ 
имъэԓиԓьын риӈэгъи выква иннин уӈииԓьын 	 и м ъ э ԓ и _  ԓ ь ы _  н _ р и ӈ э _  г ъ _ и _ в ы к в а _ и н _  н и _ н _ у ӈ и и _ ԓьы _ н _ _ 
рымутԓытъэвнин	 р ы м у т ԓ ы т ъ э в _  н и _ н _ 
уӈииԓьын	 у ӈ и и _ ԓьы _  н _ 
эрэтгъи гэԓыткынык итгъи мъэԓиԓьэ выквыԓгын тиӈунин	 э р э т _ гъ _ и _ г э _  ԓ ы т к ы н ы _ к _ и т _ гъ _ и _ м ъ э ԓ и _  ԓ ь _  э _ в ы к в ы _ ԓгы _ н _ т _  и ӈ у _ ни _ н _ 
иӈӄун нъынчимэвнин ԓевыт	 и ӈ ӄ у н _ н _  ъ ы н ч и м э в _  н и _ н _ ԓ е в ы т _ 
иӈӄун нъывъигъэн	 и ӈ ӄ у н _ н _  ъ ы в ъ и _  г ъ э _ н _ 
эчги тиӈунин имъэԓиԓьэ аԓыгаттэ	 э ч г и _ т _  и ӈ у _ ни _ н _ и м ъ э ԓ и _  ԓ ь _  э _ а ԓ ы г _ ат _  т э _ 
ԓюур рыркайӈын пиврэгъи эчги	 ԓ ю у р _ р ы р к а _  й ӈ ы _ н _ п и в р э _  г ъ _ и _ э ч г и _ 
ынӈот рыннин эчги тымыркынэнрыркайӈа	 ы н ӈ о _ т _ р ы н _ нин _ э ч г и _ т ы _  м ы р к ы н _  э н _  р ы р к а й _  ӈ а _ 
ранӈавнэн уӈииԓьын уйӈэ ръэнут	 р а _  н ӈ а в _ нэн _ у ӈ и и _ ԓьы _ н _ у й ӈ э _ р ъ э н у т _ 
гэԓьуԓин ганӈатԓен ынӄоры имъэԓиԓьын рагтыгъэ пыкирык	 г э _  ԓ ь у _ ԓин _ г а _  н ӈ а т _  ԓ е н _ ы н ӄ о р ы _ и м ъ э ԓ и _  ԓ ь ы _ н _ р а _ гты _  г ъ э _ п ы к и р ы _ к _ 
эвын гэмутԓыԓин никвъэн тумгэ ынӄэйына	 э в ы н _ г э _  м у т ԓ ы _  ԓ и н _ н _  и к _ въэ _ н _ т у м г _  э _ ы н ӄ э й _ ына _ 
гэнъаԓыгатгапԓен чит энмэн уӈииԓьыт гэнԓьэтэтъюуԓинэт	 г э _  н ъ а ԓ ы г _  а т _  г а п _  ԓ е н _ ч и т _ э н м э н _ у ӈ и и _ ԓьы _  т _ г э _ н _  ԓ ь э т _  э т ъ ю у _  ԓ и н э _ т _ 
нэмыӄэй энарэрыԓьа гинэԓьуԓин	 н э м ы ӄ э й _ э н а р э р ы _ ԓь _  а _ г _  и н э _  ԓ ь у _ ԓин _ 
гэнъаԓыгатгапԓен паагъэ риӈэк эԓеръугъи панэна эмэԓевкыԓьин	 г э _  н ъ а ԓ ы г _  а т _  г а п _  ԓ е н _ п а а _  г ъ _ э _ р и ӈ э _  к _ э ԓ е _  р ъ у _ гъ _ и _ п а н э н _ а _ э м _  э ԓ е в _  к ы _ ԓь _  и н _ 
ԓевыт иквъи эптэ гым мычавчывантагъак	 ԓ е в ы т _ и к _ въ _ и _ э п т э _ гым _ м ы ч _  а в ч ы в а н т а _  г ъ а _  к _ 
ԓьораӄоймагты имъэԓиԓьыт ӄытгъэт пыкиргъэт ԓьораӄоймак эвын	 ԓ ь о _  р а ӄ _  о й м а _  г т ы _ и м ъ э ԓ и _  ԓ ь ы _  т _ ӄ ы т _  г ъ э _ т _ п ы к и р _ гъэ _ т _ ԓ ь о _  р а ӄ _  о й м а _  к _ э в ы н _ 
уӈииԓьыт ынкы нэмыӄэй	 у ӈ и и _ ԓьы _ т _ ы н _ кы _ н э м ы ӄ э й _ 
атынвыԓьын ынкы ӄытԓыги ынин	 а т ы н в ы _  ԓ ь ы _  н _ ы н _ кы _ ӄ ы т ԓ ы г и _ ы н _  и н _ 
атынватъё ымыӈ гачавчывантаԓен	 а т ы н в а т ъ ё _ ы м ы _  ӈ _ г а ч а в ч ы в а н т а _  ԓ е н _ 
ӈирэче кивкы ӄытгъи	 ӈ и р э _  ч е _ к и в _ кы _ ӄ ы т _ гъ _ и _ 
уӈииԓьын ивнин имъэԓиԓьэ ивнин	 у ӈ и и _ ԓьы _  н _ и в _ ни _ н _ и м ъ э ԓ и _  ԓ ь _  э _ и в _ ни _ н _ 
гым эквырга тымэйӈэтык ынӈин ваԓьэгым уӈииԓьэ нинивӄин	 г ы м _ э к _ вырга _ т ы _  м э й ӈ _  э т ы к _ ы н ӈ и н _ в а _  ԓ ь _ эгым _ у ӈ и и _  ԓ ь _ э _ н _  и н _ ив _ ӄин _ 
ӄэйвэ мэԓгыт тыԓьугыт	 ӄ э й в э _ м _  э ԓ г ы т _ т ы _  ԓ ь у _  г ы т _ 
ԓьэԓеӈкы риӈэк имъэԓиԓьэ	 ԓ ь э ԓ е ӈ _ кы _ р и ӈ э _  к _ и м ъ э ԓ и _  ԓ ь _  э _ 
нинивӄин эты эԓвэԓьин	 н _  и н _ ив _ ӄин _ э т ы _ э ԓ в э _ ԓь _ ин _ 
уӈииԓьэ тумгыт нинивӄинэт	 у ӈ и и _  ԓ ь _  э _ т у м г ы _ т _ н _  и н _ ив _ ӄинэ _ т _ 
тумгэ нивӄин ӄэгԓынангэт	 т у м г _  э _ н _  и в _ ӄин _ ӄ э г ԓ ы _ нан _ гэт _ 
ԓёӈынма рагтыгъат имъэԓиԓьыт пыкиргъэт румэкэвнин	 ԓ ё ӈ ы _  н _ ма _ р а _ гты _ гъа _ т _ и м ъ э ԓ и _  ԓ ь ы _ т _ п ы к и р _ гъэ _ т _ р у м э к _ эв _ ни _  н _ 
имъэԓиԓьыт ымыԓьо ивнинэт ӄоԓ имъэԓиԓьын иквъи экык иквъи ытԓьата	 и м ъ э ԓ и _  ԓ ь ы _ т _ ы м ы ԓ ь о _ и в _ ни _  н э _ т _ ӄ о ԓ _ и м ъ э ԓ и _  ԓ ь ы _ н _ и к _ въ _ и _ э к ы к _ и к _ въ _ и _ ы т ԓ ь а _ та _ 
ивнин вэчьым гыт ымыӈ рэӄысӄычевыӈ ӄырым ӄыетги	 и в _ ни _ н _ в э ч _ ьым _ г ы т _ ы м ы _  ӈ _ р э ӄ ы _  с ӄ ы ч е в ы _  ӈ _ ӄ ы р ы м _ ӄ ы _  е т _ г _ и _ 
ӄынвэр ынӄэн эккэӄэй никвъэн имъэԓиԓьэ нэмэ экык риӈэгъи нэмэ выквыԓгын	 ӄ ы н в э р _ ы н ӄ э н _ э к к э _  ӄ э й _ н _  и к _ въэ _ н _ и м ъ э ԓ и _  ԓ ь _  э _ н э м э _ э к ы к _ р и ӈ э _ гъ _ и _ н э м э _ в ы к в ы _ ԓгы _ н _ 
пэнин патгыргыԓгын ԓьунин гыргоԓ ԓыгэн ынкэгйит гатааԓен	 п э н и н _ п а т г ы р г ы _  ԓ г ы _ н _ ԓ ь у _ ни _ н _ г ы р г о ԓ _ ԓ ы г э н _ ы н к э г _ йит _ г а _  т а а _  ԓ е н _ 
пинтыӄэтгъи гыргоԓ эвын	 п и н т ы ӄ э т _ гъ _ и _ г ы р г о ԓ _ э в ы н _ 
ынкы ԓьунин ӈагчыӈын никвыӄин	 ы н _ кы _ ԓ ь у _ ни _ н _ ӈ а г ч ы _ ӈы _ н _ н _  и к _  в ы _ ӄин _ 
ынкэгйит ныԓеӄин иквъи миӈкэтэ гыргоча мытаан юур никвъэн	 ы н к э г _ йит _ н ы _  ԓ е _ ӄин _ и к _ въ _ и _ м и ӈ _  к э _ тэ _ г ы р г о ч а _ м ы т _  а а н _ ю у р _ н _  и к _ въэ _ н _ 
ыныкит ынкы рэймэвнин	 ы н ы _ кит _ ы н _ кы _ р _  э й м э в _ ни _ н _ 
эвын ытԓыгын ынин ынкы варкын кымъыйӈа	 э в ы н _ ы т ԓ ы г ы _ н _ ы н _ ин _ ы н _ кы _ в а _  р к ы н _ к ы м ъ ы й ӈ а _ 
гэпириԓин мынга гытката эккэтэ ԓьунин ытԓыгын	 г э _  п и р и _ ԓин _ м ы н _  г а _ г ы т к а _  т а _ э к к э _ тэ _ ԓ ь у _ ни _ н _ ы т ԓ ы г ы _ н _ 
гаԓягъэ ивнин ивнин эккэтэ ивнин тыԓӄыриргыт ытԓыгэ ивнин ӈотӄэн	 г а ԓ я _  г ъ э _ и в _ ни _ н _ и в _ ни _ н _ э к к э _  т э _ и в _ ни _ н _ т ы _  ԓ ӄ ы р и р г ы _  т _ ы т ԓ ы г _ э _ и в _ ни _ н _ ӈ о т _ ӄэн _ 
кымъыԓгын нымэйыӈӄин коԓё гыткат	 к ы м ъ ы _  ԓ г ы _ н _ н ы _  м э й ы ӈ _  ӄ и н _ к о ԓ ё _ г ы т к а _ т _ 
нымкыӄинэт нивԓыӄинэт	 ны _  м к ы _  ӄ и н э _ т _ н _  и в ԓ ы _ ӄинэ _ т _ 
вайым гым ымыԓьо вагыԓгын гинэпԓин чамъам трэриӈэгъэ ӄонпыӈ гым ӈутку тынъэԓык эккэтэ ивнин тиӈунин	 в а _ йым _ г ы м _ ы м ы ԓ ь о _ в а г ы _ ԓгы _ н _ г _  и н э _  п ԓ и н _ ч а м ъ а м _ т _  р э _  р и ӈ э _  г ъ _  э _ ӄ о н п ы _  ӈ _ г ы м _ ӈ у т к у _ т ы _  н ъ э ԓ ы _  к _ э к к э _ тэ _ и в _ ни _ н _ т _  и ӈ у _ ни _ н _ 
выквыԓгын выквыԓгын ринтынин	 в ы к в ы _ ԓгы _ н _ в ы к в ы _ ԓгы _ н _ р и н т ы _ нин _ 
 кымъыԓгын кымъукэтгъи ытԓыгын пынԓёнэн	 _ к ы м ъ ы _  ԓ г ы _ н _ к ы м ъ у к э т _  г ъ _ и _ ы т ԓ ы г ы _ н _ п ы н ԓ ё _  н э н _ 
ивнин ытԓыгэ	 и в _ ни _ н _ ы т ԓ ы г _ э _ 
нэмэ	 н э м э _ 
тиӈунин нэмэ ринтынин нэмэ	 т _  и ӈ у _ ни _ н _ н э м э _ р и н т ы _  н и н _ н э м э _ 
кымъукэтгъи гынмыԓкинэк майыӈкы	 к ы м ъ у к э т _  г ъ _ и _ г ы н м ы ԓ _  к и н э _ к _ м а й ы ӈ _ кы _ 
ытԓыгын пынԓёнэн нэмэ	 ы т ԓ ы г ы _ н _ п ы н ԓ ё _  н э н _ н э м э _ 
тиӈунин ӈыроӄавкы ринтынин кымъыԓгын	 т _  и ӈ у _ ни _ н _ ӈ ы р о ӄ а в _  к ы _ р и н т ы _ нин _ к ы м ъ ы _  ԓ г ы _ н _ 
ымыԓьэты	 ы м ы ԓ ь _ эты _ 
ӄынур тымнэн гыткат	 ӄ ы н у р _ т ы м _ нэн _ г ы т к а _ т _ 
янра ымыӈ ынин	 я н р а _ ы м ы _  ӈ _ ы н _  и н _ 
ытԓыгын тымнэн	 ы т ԓ ы г ы _ н _ т ы м _ нэн _ 
ынӄо груԓмыгъи	 ы н ӄ о _ г _  р у _ ԓмы _  г ъ _  и _ 
ытԓыгин инничгын ԓьунин	 ы т ԓ ы г и н _ и н н _ ичгы _ н _ ԓ ь у _ ни _ н _ 
ынӄэн эйминнин иквъи	 ы н ӄ э н _ э й м и н _ ни _ н _ и к _ въ _ и _ 
вэԓерым ытԓыгын тыԓьугъэн ӈотӄэн	 в э ԓ е _  р ы м _ ы т ԓ ы г ы _ н _ т ы _  ԓ ь у _  г ъ э _ н _ ӈ о т _ ӄэн _ 
эмэԓкэ ытԓыгын тынрагтатын ӈэвъэнэ рэԓьугнин ӄэгԓынангэт агтыгъэ пыкирык ивнин ԓюур ынӄэн ытԓьата	 э м _  э ԓ _ к _ э _ ы т ԓ ы г ы _  н _ т ы _  н _  р а _ гт _ аты _ н _ ӈ э в ъ э н _ э _ р э ԓ ь _ уг _ ни _ н _ ӄ э г ԓ ы _ нан _ гэт _ а _ гты _  г ъ _  э _ п ы к и р _  ы к _ и в _ ни _ н _ ԓ ю у р _ ы н ӄ э н _ ы т ԓ ь а _ та _ 
ивнин мэӈӄо ԓьугьэн эккэтэ	 и в _ ни _ н _ м э ӈ _ ӄо _ ԓ ь у _  г ь э _ н _ э к к э _ тэ _ 
ивнин наӄам ымыԓьо гыткаԓгыт нымкыӄин эвын аӄаятыӈ гымнин ытԓыгын кымъэ гэпириԓин ытԓьата ивнин эккэтэ ивнин	 и в _ ни _ н _ н а ӄ а м _ ы м ы ԓ ь о _ г ы т к а _  ԓ г ы т _ н ы _  м к ы _ ӄин _ э в ы н _ а _  ӄ а я т ы _  ӈ _ г ы м _  н и н _ ы т ԓ ы г ы _ н _ к ы м ъ _ э _ г э _  п и р и _ ԓин _ ы т ԓ ь а _ та _ ив _ ни _ н _ э к к э _ тэ _ ив _ ни _ н _ 
эмимъэԓик тынъэԓык ӄырым ԓым ыяагты мыԓӄытык	 э _  м и м ъ э ԓ и _  к _ т ы _  н ъ э ԓ ы _ к _ ӄ ы р ы м _ ԓ ы м _ ы я а г т ы _ м ы _  ԓ ӄ ы _ тык _ 
вэԓерым ытԓыгын тыԓьугъэн ӄонпыӈ	 в э ԓ е _  р ы м _ ы т ԓ ы г ы _ н _ т ы _  ԓ ь у _  г ъ э _ н _ ӄ о н п ы _  ӈ _ 
игыр тыпаак ытръэч эвэнэԓьэты игыр трэвинрээркын игыр ӄонпыӈ	 и г ы р _ т ы _  п а а _  к _ ы т р ъ э ч _ э в э н э _  ԓ ь _  э т ы _ и г ы р _ т _  р э _  в и н р э э _  р к ы н _ и г ы р _ ӄ о н п ы _ ӈ _ 
ыяагты риӈэк тыпаак с	 ы я а г т ы _ р и ӈ э _  к _ т ы _  п а а _  к _ с _ 
амыным аны ныԓгэӈъоӄэн ымы ваԓы чаат	 а м _ ыным _ а н ы _ н ы _  ԓ г э _  ӈ ъ о _  ӄ э н _ ы м ы _ в а ԓ ы _ ч а а т _ 
кукэт пойгыт уйӈэ наӄам	 к у к э т _ п о _  й г ы т _ у й ӈ э _ н а ӄ а м _ 
ӈэԓвыԓ нымкыӄин	 ӈ э ԓ в ы ԓ _ н ы _  м к ы _ ӄин _ 
энмэн нанӄытэмтэӈ ганымытваԓен	 э н м э н _ н _  а н ӄ ы т э м т э _  ӈ _ г а _  н ы _ мытва _  ԓ е н _ 
ытръэч тэӈэмӈэԓвыԓекы уйӈэ	 ы т р ъ э ч _ т э ӈ _  э м _  ӈ э ԓ в ы ԓ е _  к ы _ у й ӈ э _ 
аракыԓьэн ымы ԓыгэн	 а _  р а _  к ы _ ԓь _ эн _ ы м ы _ ԓ ы г э н _ 
ӄун ӈэвъэн уйӈэ таӈамынан	 ӄ у н _ ӈ э в ъ э _ н _ у й ӈ э _ т а ӈ _ ам _  ы н а н _ 
ганымытваԓен ӈэԓвыԓекы амыным	 г а _  н ы _ мытва _  ԓ е н _ ӈ э ԓ в ы ԓ е _ кы _ а м _ ыным _ 
аны ныԓгэӈъоӄэн ымы	 а н ы _ н ы _  ԓ г э _  ӈ ъ о _  ӄ э н _ ы м ы _ 
ваԓы чаат кукэт	 в а ԓ ы _ ч а а т _ к у к э т _ 
пойгыт уйӈэ наӄам ӈэԓвыԓ нымкыӄин	 п о _  й г ы т _ у й ӈ э _ н а ӄ а м _ ӈ э ԓ в ы ԓ _ н ы _  м к ы _ ӄин _ 
энмэн нанӄытэмтэӈ ынӄэн	 э н м э н _ н _  а н ӄ ы т э м т э _  ӈ _ ы н ӄ э н _ 
нынны ынин аны ныԓгэӄамэтваӄэн	 н ы н н ы _ ы н _  и н _ а н ы _ н ы _  ԓ г э _  ӄ а м э т в а _  ӄ э н _ 
ыныкит гытъэвкы ӄоԓ	 ы н ы _ кит _ г ы т ъ э в _ кы _ ӄ о ԓ _ 
итгъи вуԓӄытвик ӄаанматгъэ ԓыгэн	 и т _ гъ _ и _ в у ԓ ӄ ы _ тви _ к _ ӄ а а н м а т _  г ъ э _ ԓ ы г э н _ 
кытгынтыпэрэта рыннин ӄораӈы наӄам	 к ы т г ы н т ы _  п э р э т _  а _ р ы н _ нин _ ӄ о р а _ ӈы _ н а ӄ а м _ 
аны ныԓгининъыӄин нанӄытэмтэӈ чама	 а н ы _ н ы _  ԓ г и _  н и _ нъы _ ӄин _ н _  а н ӄ ы т э м т э _  ӈ _ ч а м а _ 
ныԓгэнымԓыӄэн ынӄэн ынкы	 ны _  ԓ г э _ ны _ мԓы _ ӄэн _ ы н ӄ э н _ ы н _ кы _ 
кытгынтыпэрэнэн ӄораӈы ынӄо риԓгыпэтэ	 к ы т г ы н т ы _  п э р э _  н э н _ ӄ о р а _ ӈы _ ы н ӄ о _ р _  и ԓ г ы п э т э _ 
рыннин ынраӄ эрынвэ рыннинэт гыткат ԓыгэн мыԓенинэт гыткат мынга ынӄо тэтивэԓе инэвэнӈэтгъи	 р ы н _ нин _ ы н р а _ ӄ _ э р ы н в э _ р ы н н и н э _ т _ г ы т к а _ т _ ԓ ы г э н _ м ы _  ԓ е н _  и н э _ т _ г ы т к а _ т _ м ы н _  г а _ ы н ӄ о _ т э т _  и в э ԓ _  е _ и н э _  в э н ӈ э т _ гъ _  и _ 
ынӄо ӄорэн нанӄын тэйкынин	 ы н ӄ о _ ӄ о р э _ н _ н _  а н ӄ ы _  н _ т э й к ы _ ни _ н _ 
ынкъам мэмԓытыёнэн ынӄо рыратыквыткынык рытриԓнин ынӈин нувиӄин нанӄытэмтэӈ	 ы н к ъ а м _ м э м ԓ ы т ы _  ё _  н э н _ ы н ӄ о _ р ы р а _  т ы к в ы _ ткыны _ к _ р ы т _ риԓ _ ни _ н _ ы н ӈ и н _ н _  у в и _ ӄин _ н _  а н ӄ ы т э м т э _  ӈ _ 
ӄорананӄыткынык вычгывыквыткынык таӈымыԓьэты ыпаннэн аймак	 ӄ о р а _  н а н ӄ ы _  т к ы н ы _ к _ в ы ч г ы _  в ы к в ы _  т к ы н ы _ к _ т а ӈ _  ы м ы ԓ ь _ эты _ ы п а н _  н э _  н _ а й м а _ к _ 
ынӄо гатарыгъёԓгынԓен нанӄыванвыԓӄыԓ гэтэйкыԓин	 ы н ӄ о _ г а _  т а _  р ы г ъ _  ё ԓ г ы н ԓ е н _ н _  а н ӄ ы _  в а н в ы _  ԓ ӄ ы ԓ _ г э _  т э й к ы _ ԓин _ 
амыным ӄамэтваӈӈогъэ	 а м _ ыным _ ӄ а м э т в а _  ӈ ӈ о _  г ъ _ э _ 
апаӄатԓыткогъэ аны гаӄамэтваԓен таӈымыԓьэты	 а п а ӄ _  а т ԓ ы т к о _  г ъ _ э _ а н ы _ г а _  ӄ а м э т в а _ ԓен _ т а ӈ _  ы м ы ԓ ь _ эты _ 
кунин ӄаанмэ	 к у _ ни _ н _ ӄ а а н м _  э _ 
ынӄо ӄутгъи	 ы н ӄ о _ ӄ у т _  г ъ _ и _ 
нанӄыйӈын гэԓгимэйӈэтԓин гагэнрычгатԓен ынӄо ӈиԓгэ тимтигнин нанӄын	 н а _  н _  ӄ ы _  й ӈ ы _ н _ г э _ ԓги _  м э й ӈ _ эт _ ԓин _ г а _  г э н _  р ы ч г _ ат _ ԓен _ ы н ӄ о _ ӈ и ԓ г _ э _ т и м т и г _ ни _  н _ н _  а н ӄ ы _ н _ 
ӈэԓвыԓ вэгтиԓгъи наӄам ыныкит ныгытъэвӄин	 ӈ э ԓ в ы ԓ _ в э г т и ԓ _ гъ _ и _ н а ӄ а м _ ы н ы _ кит _ н ы _  г ы т ъ э в _  ӄ и н _ 
ныԓгимӄытвиӄин нанӄын наӄам ыныкит ныпԓыӄамэтваӄэн	 ны _  ԓ г и _  м ӄ ы _ тви _ ӄин _ н _  а н ӄ ы _ н _ н а ӄ а м _ ы н ы _ кит _ н ы _  п ԓ ы ӄ а м э т в а _  ӄ э н _ 
ныԓгэгэнрычгатӄэн нанӄын рыпэт	 ны _  ԓ г э _  г э н _  р ы ч г _ ат _ ӄэн _ н _  а н ӄ ы _ н _ р ы п э т _ 
ӄун кыԓтэ	 ӄ у н _ к ы ԓ т _  э _ 
нинэтчыӄин нанӄын ынӄэн	 н _ инэ _  т ч ы _  ӄ и н _ н _  а н ӄ ы _ н _ ы н ӄ э н _ 
тэӈэмынӈин ганымытваԓен тумгэӄэй нанӄытэмтэӈ амын ӄоԓ итгъи вуԓӄытвик нэмэ ӄаанматгъэ ынраӄ нымэчыӄэргыԓьатӄэн	 т э ӈ _  э м ы н _ ӈин _ г а _  н ы _ мытва _  ԓ е н _ т у м г э _ ӄэй _ н _  а н ӄ ы т э м т э _  ӈ _ а м _  ы н _ ӄ о ԓ _ и т _ гъ _ и _ в у ԓ ӄ ы _ тви _ к _ н э м э _ ӄ а а н м а т _  г ъ э _ ы н р а _ ӄ _ н ы _  м э ч ы _  ӄ э р г ы _  ԓ ь а т _ ӄэн _ 
увэма ӈэԓвыԓым нытԓытваӄэн ԓюур вай рымъэйӈэткун авач авач ԓыгэн эвыр	 у в э м _ а _ ӈ э ԓ в ы _  ԓ ы м _ н ы _  т ԓ ы т в а _  ӄ э н _ ԓ ю у р _ вай _ р ы м _  ъ э й ӈ э _  т к у _  н _ а в а ч _ а в а ч _ ԓ ы г э н _ э в ы р _ 
гагчыръогъэ нанӄытэмтэӈ эӄыԓпэ эръыкыргыт ӈирэӄ энатыёйвынэнат уунъыкэнъутэ ынкъам рытрэтэ	 г а _  г ч ы _ ръо _  г ъ _ э _ н _  а н ӄ ы т э м т э _  ӈ _ э ӄ ы ԓ п э _ э р ъ ы _  к ы р г ы _  т _ ӈ и р э ӄ _ э н _  а т ы _  ё _  й в ы _  н _  э н а _ т _ у у н ъ ы _  к э н ъ у т _  э _ ы н к ъ а м _ р ы т р э _  т э _ 
ԓьуԓӄыԓеннинэт ынӄоым мачыяа рывакъовнэнат ӈирэк рытрэԓьуԓӄытԓьэт	 ԓ ь у _  ԓ ӄ ы _  ԓ е н _  н и _  н э _ т _ ы н ӄ о ы м _ м а ч ы _  я а _ р ы _  в а к ъ о _  в _  н э _  н а _ т _ ӈ и р э _  к _ р ы т р э _  ԓ ь у _  ԓ ӄ ы т _  ԓ ь э т _ 
эръыкыргыт аны ӈоты	 э р ъ ы _  к ы р г ы _  т _ а н ы _ ӈ о т ы _ 
энмэч гапкэрыӈӈоԓен ӄытԓыги эӄэԓьымкын ӈэԓвыԓым ынкы	 э н м э ч _ г а _  п к э р ы _ ӈӈо _ ԓен _ ӄ ы т ԓ ы г и _ э _  ӄ э ԓ ь ы _  м к ы _ н _ ӈ э ԓ в ы _  ԓ ы м _ ы н _ кы _ 
нытԓытваӄэн панэна ынӄо атчысӄэквъэ нанӄытэмтэӈ	 ны _  т ԓ ы т в а _  ӄ э н _ п а н э н _ а _ ы н ӄ о _ а т ч ы с ӄ э к _  в ъ _  э _ н _  а н ӄ ы т э м т э _  ӈ _ 
омкычыкогты аны вай ныԓӄэгнэвъюуӄинэт	 о м к ы _ чыко _  г т ы _ а н ы _ в а й _ н ы _  ԓ _  ӄ э г н э _  в ъ ю у _  ӄ и н э _ т _ 
мачыяа вакъотваԓьыт	 м а ч ы _  я а _ в а к ъ о _  т в а _ ԓьы _  т _ 
эръыкыргыт тиӈурэ нынпыткэвъюуӄинэт	 э р ъ ы _  к ы р г ы _  т _ т _  и ӈ у р э _ н ы _  н _  п ы т к э _  в ъ ю у _  ӄ и н э _ т _ 
тиӈурмъэмитэ вачаӄ	 т _  и ӈ у р _  м ъ э _ мит _  э _ в а ч а ӄ _ 
ванэван ынынпэӄэттавынат эръыкыргыт	 в а н э в а н _ ы н ы _  н п э ӄ э т _  т а в ы _  н а _ т _ э р ъ ы _  к ы р г ы _  т _ 
миӈкыри ӄун нивӄинэт ытри энмэн ынӄэнат	 м и ӈ _ кы _ ри _ ӄун _ н _  и в _  ӄ и н э _ т _ ы т р и _ э н м э н _ ы н ӄ э н а _  т _ 
 ӈирэӄ оравэтԓьат натаӈыԓвавынат тымык	 _ ӈ и р э ӄ _ о р а в э т ԓ ь а _  т _ н а т а _  ӈ ы ԓ в а в ы _  н а _ т _ т ы _  м ы к _ 
ӄынвэр найъонат ӈирэӄ эръыкыргыт ӄытԓыги ынӄэнат эръыкыргыт ытръэч уунъыкэнъутэ гэнатыёԓенат выԓ нымкыӄин наӄам уйӈэ этынвыка	 ӄ ы н в э р _ н а _  й ъ о _  н а _ т _ ӈ и р э ӄ _ э р ъ ы _  к ы р г ы _  т _ ӄ ы т ԓ ы г и _ ы н ӄ э н а _  т _ э р ъ ы _  к ы р г ы _  т _ ы т р ъ э ч _ у у н ъ ы _  к э н ъ у т _  э _ г _  э н а _  т ы ё _  ԓ е н а _ т _ в ы ԓ _ н ы _  м к ы _  ӄ и н _ н а ӄ а м _ у й ӈ э _ э т ы н в ы _  к _ а _ 
опопы моргынан	 о п о п ы _ м о р г ы _ нан _ 
ӈэԓвыԓ мыныԓгын миӈкыри ӄун эми авынраԓьыт энмэч эргатык	 ӈ э ԓ в ы ԓ _ м ы н ы _  ԓ г ы _ н _ м и ӈ _ кы _ ри _ ӄ у н _ э м _  и _ а в ы н р а _  ԓ ь ы _  т _ э н м э ч _ э р г _ атык _ 
мынагтатын ӈэԓвыԓ тумгытым ночыткоӄэнат	 м ы н _  а г т а т ы _  н _ ӈ э ԓ в ы ԓ _ т у м г ы _  т ы м _ н о ч ы _ тко _  ӄ э н а _ т _ 
нанвэтгавын ӈэԓвыԓ эргатык агтатынвы амыным энмэч тэӈунтымэквъэт ынкы ӄамэтваԓьатгъат ынкы эчги ӄэмипԓыткугъэт ынкы	 н а _  н _  в э т г а в ы _  н _ ӈ э ԓ в ы ԓ _ э р г _ атык _ а г т _  а т ы н в ы _ а м _ ыным _ э н м э ч _ т э ӈ _  у н _  т ы м э к _  в ъ э _ т _ ы н _ кы _ ӄ а м э т в а _  ԓ ь а т _  г ъ а _ т _ ы н _ кы _ э ч г и _ ӄ э м и п ԓ ы т к у _  г ъ э _ т _ ы н _ кы _ 
ԓыгэн йыԓӄатчагъат наӄам таӈымыԓьо ирвыгинив ыннэнԓеӈкы натанмайӈэвынат ынӄоым йыԓӄатчагъат амыным нанӄытэмтэӈына чамэттанэнат	 ԓ ы г э н _ й ы ԓ ӄ _  а т ч а _ гъа _ т _ н а ӄ а м _ т а ӈ _  ы м ы ԓ ь о _ и р в ы г и _  н _  и в _ ы н н э н _  ԓ е ӈ _  к ы _ н а т а н _  м а й ӈ _  э в ы _  н а _ т _ ы н ӄ о ы м _ й ы ԓ ӄ _  а т ч а _ гъа _ т _ а м _ ыным _ н _  а н ӄ ы т э м т э ӈ _  ы н а _ ч а м э т т а _ нэ _ на _ т _ 
йыԓӄыԓьыт йъонэнат эвын	 й ы ԓ ӄ ы _ ԓьы _  т _ й ъ о _ нэ _ на _ т _ э в ы н _ 
таӈвытрыӈ ныйыԓӄатчаӄэнат аӄаԓымкиӈыт ынӄо танмайӈытваԓьыт ирвыгинив майынԓяйвынэнат нотагты омкычыкогты ынӄо йъонэнат	 т а ӈ _  в ы т р ы _ ӈ _ н ы _  й ы ԓ ӄ _  а т ч а _ ӄэна _ т _ а _  ӄ а ԓ ы _  м к и ӈ ы _  т _ ы н ӄ о _ т а н _  м а й ӈ ы _  т в а _  ԓ ь ы _  т _ и р в ы г и _  н _  и в _ м а й ы н ԓ я _  й в ы _  н _  э н а _ т _ н о т а _  г т ы _ о м к ы _ чыко _  г т ы _ ы н ӄ о _ й ъ о _ нэ _  н а _ т _ 
йыԓӄыԓьыт ытръэч ыннэн пойгын рынрынин	 й ы ԓ ӄ ы _ ԓьы _  т _ ы т р ъ э ч _ ы н н э н _ п о й г ы _ н _ р ы н р ы _ ни _ н _ 
эвын ныӄынӈырвэԓыръоӄэнат эӄэԓьыгинив	 э в ы н _ н ы _  ӄ ы н ӈ ы _  р в _  э ԓ ы _  р ъ о _  ӄ э н а _ т _ э _ ӄэԓьы _  г и н _ ив _ 
аны рымъэйӈэнинэт эӄэԓьыгинив	 а н ы _ р ы м _  ъ э й ӈ э _  н и _  н э _ т _ э _ ӄэԓьы _  г и н _ ив _ 
ынӄо йъонэнат йыԓӄыԓьыт ытръэч ыннэн пойгын	 ы н ӄ о _ й ъ о _ нэ _  н а _ т _ й ы ԓ ӄ ы _ ԓьы _  т _ ы т р ъ э ч _ ы н н э н _ п о й г ы _ н _ 
рынрынин эвын ныӄынӈырвэԓыръоӄэнат эӄэԓьыгинив аны рымъэйӈэнинэт эӄэԓьыгинив аны гараԓеԓӄотчаԓенат	 р ы н р ы _ ни _ н _ э в ы н _ н ы _  ӄ ы н ӈ ы _  р в _  э ԓ ы _  р ъ о _  ӄ э н а _ т _ э _ ӄэԓьы _  г и н _ ив _ а н ы _ р ы м _  ъ э й ӈ э _  н и _  н э _ т _ э _ ӄэԓьы _  г и н _ ив _ а н ы _ г а _  р а ԓ е ԓ _  ӄ о т ч а _  ԓ е н а _ т _ 
аӄаԓьымкычгын ԓыгэн ԓыԓенвэнтинэӈу ныпойгырэтръоӄэнат уйӈэ	 а _  ӄ а ԓ ь ы _  м к ы ч г ы _ н _ ԓ ы г э н _ ԓ ы ԓ е н в э н _  т и н э _  ӈ у _ н ы _  п о й г ы р э т _  р ъ о _ ӄэна _ т _ у й ӈ э _ 
ԓьук ныԓвавӄэнат аны ынкы кэмчичевръуԓьыт	 ԓ ь у _  к _ н ы _  ԓ в а в _  ӄ э н а _ т _ а н ы _ ы н _ кы _ к э м ч и ч е в _  р ъ у _  ԓ ь ы _ т _ 
ԓыгэн нэнанмыткойвыӄэнат пойга нанӄытэмтэӈына	 ԓ ы г э н _ н _  э н а _  н м ы _  т к о _  й в ы _ ӄэна _ т _ п о _  й г а _ н _  а н ӄ ы т э м т э ӈ _  ы н а _ 
ынкы тымыткойвынэнат таӈымыԓьо	 ы н _ кы _ т ы _  м ы т к о _  й в ы _ н _  э н а _ т _ т а ӈ _ ымыԓьо _ 
ынӄо	 ы н ӄ о _ 
тумгэӄэй нанӄытэмтэӈ ирвынӈэгъи игырым эӄэԓьэ нарынноркын	 т у м г э _ ӄэй _ н _  а н ӄ ы т э м т э _  ӈ _ и р в ы _  н ӈ э _ гъ _  и _ и г ы р ы м _ э _  ӄ э ԓ _ ь _ э _ н _  а р ы н н о _  р к ы н _ 
вуԓӄытвигъи	 в у ԓ ӄ ы _ тви _  г ъ _ и _ 
ԓюур ӈайъэннысӄэпы ининигъи	 ԓ ю у р _ ӈ а й _  ъ э н _  н ы _  с _  ӄ э п ы _ и н _ ини _ гъ _ и _ 
этратчыӈын эвын гаӄоԓема ныԓгирымъэйӈэткуӄинэт	 э т р а _ тчы _  ӈ ы _ н _ э в ы н _ г а _  ӄ о ԓ е _ ма _ н ы _  ԓ г и _  р ы м _  ъ э й ӈ э _  т к у _ ӄинэ _ т _ 
нанӄытэмтэӈ нанӄытэмтэӈым нытаӈонтымытваӄэн таӈванэван найыԓгавын энмэч нытэнмавыткоӄэн ԓюур	 н _  а н ӄ ы т э м т э _  ӈ _ н _  а н ӄ ы т э м т э _  ӈ ы м _ н ы _  т а ӈ _  о н т ы _  м ы т в а _  ӄ э н _ т а ӈ _  в а н э в а н _ н а _  й ы ԓ _  г а в ы _ н _ э н м э ч _ н ы _  т э _  н м а в ы _  т к о _  ӄ э н _ ԓ ю у р _ 
пыкэтчагъат аӄаԓымкиӈын накамԓеԓтагъан нанӄытэмтэӈ аны	 п ы к э т ч а _ гъа _  т _ а _  ӄ а ԓ ы _  м к и ӈ ы _ н _ н а к а м _ ԓеԓта _ гъа _ н _ н _  а н ӄ ы т э м т э _  ӈ _ а н ы _ 
нанӄытэмтэӈына пойгычгын гэниԓюԓин	 н _  а н ӄ ы т э м т э ӈ _  ы н а _ п о _  й г ы ч г ы _ н _ г э _  н _  и ԓ ю _ ԓин _ 
ԓюур гыргоԓятгъэ таӈампойгыԓьата	 ԓ ю у р _ г ы р г о ԓ я _  т _  г ъ э _ т а ӈ _  а м _  п о й г ы _  ԓ ь а _  т а _ 
нанӄытэмтэӈ ооԓёкоԓё аны ныԓгинымкыӄин аӄаԓьэтратчыӈын ԓюур выентэтгъи	 н _  а н ӄ ы т э м т э _  ӈ _ о о ԓ ё к о ԓ ё _ а н ы _ н ы _ ԓги _ ны _  м к ы _ ӄин _ а _  ӄ а ԓ ь э т _  р а _  т ч ы _ ӈы _ н _ ԓ ю у р _ в ы е н т _ эт _  г ъ _ и _ 
камԓеԓтаё нанӄытэмтэӈ аны ынкы	 к а м ԓ _  е ԓ т а _  ё _ н _  а н ӄ ы т э м т э _  ӈ _ а н ы _ ы н _ кы _ 
моогъат маравкы наӄам пойгыԓьата мараквъат амыным нэмэ	 м о о _  г ъ а _ т _ м а р а в _  к ы _ н а ӄ а м _ п о й г ы _  ԓ ь а _  т а _ м а р а к _  в ъ а _ т _ а м _  ы н ы м _ н э м э _ 
нанӄытэмтэӈына тэӈыткунин	 н _  а н ӄ ы т э м т э ӈ _  ы н а _ т э ӈ ы _  т к у _  н и _ н _ 
эӄэԓьырэт этки гэрмэвԓин нанӄытэмтэӈ чама	 э _  ӄ э ԓ ь ы _  р э т _ э т _ к _ и _ г э _  р м э в _ ԓин _ н _  а н ӄ ы т э м т э _  ӈ _ ч а м а _ 
гамчытвэԓен нэмэ рымагтэты нымытваӈӈогъэ	 г а _  м ч ы _ твэ _ ԓен _ н э м э _ р ы _  м а г т _ эты _ н ы _  м ы т в а _  ӈ ӈ о _  г ъ _ э _ 
итыкым ныйъойвыӄэн эӄэԓьэ вачаӄым тымык натаӈыԓвавын ӄоԓ	 и т ы _  к ы м _ н ы _  й ъ о _  й в ы _ ӄэн _ э _  ӄ э ԓ _ ь _ э _ в а ч а _ ӄым _ т ы _  м ы к _ н а т а _ ӈыԓва _ вы _ н _ ӄ о ԓ _ 
итгъи ӈайыткынэты ёпыԓӄэквъэ нанӄытэмтэӈ	 и т _ гъ _ и _ ӈ а й _ ыткын _ эты _ ё п ы ԓ ӄ _  э к _ въ _ э _ н _  а н ӄ ы т э м т э _  ӈ _ 
ԓюур ԓьунин ынкы	 ԓ ю у р _ ԓ ь у _ ни _ н _ ы н _ кы _ 
ӈэвысӄэт ӈэйык ивтыԓ нэнамӈыԓёӄэн нанӄытэмтэӈына ӈэвысӄэт эмъим	 ӈ э в ы с ӄ э т _ ӈ э й ы к _ и в т ы ԓ _ н _  э н а _  м ӈ ы ԓ ё _ ӄэн _ н _  а н ӄ ы т э м т э ӈ _  ы н а _ ӈ э в ы с ӄ э т _ э м _  ъ и м _ 
гынин ытԓьатэвытԓымым йичьэмиттумгыт кытвыԓӄуным рэӄэ нытэйӈэтигыт ынкъам ынӈин нытэйӈэтигым ынӄо	 г ы н _ ин _ ы т ԓ ь а т _  э в ы т ԓ ы _  м ы м _ й и ч ь _ э _ мит _ тумгы _  т _ к ы т в ы ԓ _  ӄ у н ы м _ р э ӄ _  э _ н ы _  т э й ӈ э т _  и г ы т _ ы н к ъ а м _ ы н ӈ и н _ н ы _  т э й ӈ э т _  и г ы м _ ы н ӄ о _ 
ԓыгиейвэчеквъи нанӄытэмтэӈ ивнин эвыр гынин нэмыӄэй уйӈэ	 ԓ ы г _  и е й в _  э ч е к _  в ъ _ и _ н _  а н ӄ ы т э м т э _  ӈ _ и в _ ни _ н _ э в ы р _ г ы н _ ин _ н э м ы ӄ э й _ у й ӈ э _ 
опопы кынмаԓ мыннымытва	 о п о п ы _ к ы н м _ аԓ _ м ы н _  н ы _  м ы т в а _ 
ԓыгэным ӈэвысӄэт ԓыгэкоргаквъэ	 ԓ ы г э _ ным _ ӈ э в ы с ӄ э т _ ԓ ы г э _  к о р г а к _ въ _ э _ 
ынӄо эквэтгъэт ӈаԓвыԓьэты	 ы н ӄ о _ э к в э т _  г ъ э _ т _ ӈ а ԓ в ы _ ԓь _ эты _ 
аны ганымытваԓенат ынкы	 а н ы _ г а _  н ы _ мытва _ ԓена _ т _ ы н _ кы _ 
энмэчым гаранӈаԓенат ытри энмэчым	 э н м э ч ы м _ г а _  р а _  н ӈ а _  ԓ е н а _ т _ ы т р и _ э н м э ч ы м _ 
аккантогъэ ӈэвъэн йытонэн ӈинӄэй	 а к к а _  н т о _ гъ _ э _ ӈ э в ъ э _ н _ й ы т о _ нэ _ н _ ӈ и н _ ӄэй _ 
умиԓгуну нынны гитԓин ынӄо эчги	 у м и ԓ г у _  н у _ н ы н н ы _ г _  и т _ ԓин _ ы н ӄ о _ э ч г и _ 
ӈэръамытԓыӈгэвэԓьо нъэԓгъи умиԓгу нэмэ ӄоԓ ӈинӄэй урэтгъи	 ӈ э р ъ а _  м ы т ԓ ы ӈ _  г э в э _  ԓ ь _ о _ н _  ъ э ԓ _ гъ _ и _ у м и ԓ г у _ н э м э _ ӄ о ԓ _ ӈ и н _ ӄэй _ у р э т _  г ъ _ и _ 
ынӄэнат ӈинӄэгти мэйӈэтгъэт энмэч	 ы н ӄ э н а _  т _ ӈ и н _  ӄ э г _ ти _ м э й ӈ _  э т _ гъэ _ т _ э н м э ч _ 
мачамнотайпы ныԓейвыӄинэт гэтԓенъютэ ԓыгэным	 м а ч а м _  н о т а _  й п ы _ ны _  ԓ е й в ы _  ӄ и н э _ т _ г э _  т _  ԓ е н _  ъ ю т _ э _ ԓ ы г э _ ным _ 
ԓыгэыяагты ныԓӄытыԓьэтӄинэт нанӄытэмтэӈын эккэт	 ԓ ы г э _  ы я а _ гты _ ны _  ԓ ӄ ы т ы _  ԓ ь э т _  ӄ и н э _ т _ н _  а н ӄ ы т э м т э _  ӈ ы _  н _ э к к э _  т _ 
наӄам ытԓыгын пэнин ӄораӄ	 н а ӄ а м _ ы т ԓ ы г ы _ н _ п э н и н _ ӄ о р а _  ӄ _ 
ваԓьын нмэч умиԓгу мачьаачеко гэнъэтԓин ытԓеӈиым энмэч майӈыӈэнӄагчыӈын умиԓгун ытԓенъюн нынны	 в а _  ԓ ь ы _ н _ н _  м э ч _ у м и ԓ г у _ м а ч ь а а ч е к о _ г э _ нъэт _ ԓин _ ы т ԓ е ӈ _  и ы м _ э н м э ч _ м а й ӈ ы _  ӈ э н _  ӄ а г ч ы _ ӈы _ н _ у м и ԓ г у н _ ы т ԓ е н _  ъ ю _ н _ н ы н н ы _ 
 тутъыԓӄут аны ӄытԓыги	 _ т у т _  ъ ы ԓ ӄ у т _ а н ы _ ӄ ы т ԓ ы г и _ 
ытри нырэрмэвӈыӄинэт ынӄо	 ы т р и _ ны _  р _ эрмэв _ ӈы _  ӄ и н э _ т _ ы н ӄ о _ 
эчги тутъыԓӄут мэйӈэтгъи аатчеко нъэԓгъи ивнин	 э ч г и _ т у т _  ъ ы ԓ ӄ у т _ м э й ӈ _  э т _ гъ _ и _ а а т ч е к о _ н _  ъ э ԓ _ гъ _ и _ и в _ ни _ н _ 
умиԓгунэ	 у м и ԓ г у _  н э _ 
ынӄо амъянра нъэԓгъэт аны котчой нутэк нытваӄэнат тэӈэмкытэ	 ы н ӄ о _ а м _  ъ я н _ ра _ н _  ъ э ԓ _  г ъ э _ т _ а н ы _ к о т ч о _  й _ н у т э _  к _ н ы _  т в а _  ӄ э н а _ т _ т э ӈ _  э м к ы _ т _  э _ 
ярагты ныԓӄытӄинэт ԓюур ӄуԓиникэк тутъыԓӄутынэ ивнин ынээԓьын нутэк	 я р а _  г т ы _ н ы _  ԓ ӄ ы т _  ӄ и н э _ т _ ԓ ю у р _ ӄ у ԓ и н и к э _ к _ т у т _  ъ ы ԓ ӄ _  у т ы _  н _  э _ и в _ ни _ н _ ы н э э ԓ ь ы _ н _ н у т э _  к _ 
миӈкыри ӄун умиԓгу вэнъым гаԓгэмчытвэԓен ынкъам умиԓгунэ нинивӄин	 м и ӈ _ кы _ ри _ ӄун _ у м и ԓ г у _ в э н _ ъым _ г а _ ԓгэ _  м ч ы _ твэ _ ԓен _ ы н к ъ а м _ у м и ԓ г у _  н э _ н _  и н _ ив _ ӄин _ 
ытԓеӈи тутъыԓӄутынэ вэнԓыги нинивъюуӄин ынээԓьын	 ы т ԓ е _ ӈи _ т у т _  ъ ы ԓ ӄ _  у т ы _  н _  э _ в э н ԓ ы г и _ н _  и н _  и в ъ ю у _ ӄин _ ы н э э ԓ ь ы _ н _ 
еп ныппыԓюйгыт энмэч этъоонмыԓ эвыр мэчынкы	 е п _ ны _ ппыԓю _  й г ы т _ э н м э ч _ э т ъ о о _ нмыԓ _ э в ы р _ м э ч ы н _ кы _ 
рэнъэԓгъэ мачынан ынӈин ӄытваркын	 р э н ъ э ԓ _ гъ _ э _ м а ч ы _ нан _ ы н ӈ и н _ ӄ ы _  т в а _  р к ы н _ 
ынӈэ акаԓырока энмэч рымагтэты атав мынԓеркын ынӄо эквэтгъэт	 ы н ӈ э _ а к а ԓ ы р о _  к _  а _ э н м э ч _ р ы _  м а г т _ эты _ а т а в _ м ы н _  ԓ е _ ркын _ ы н ӄ о _ э к в э т _  г ъ э _ т _ 
амъянра нэмэ ӄуԓиникэк ԓьувыԓгык ивнин ытԓенъютэ	 а м _  ъ я н _ ра _ н э м э _ ӄ у ԓ и н и к э _ к _ ԓ ь у _  в ы ԓ г ы _  к _ и в _ ни _ н _ ы т ԓ е н _ ъют _ э _ 
ынээԓьэ ивнин гытым эквэтгъэт нэмэ амъянра	 ы н э э ԓ ь _ э _ и в _ ни _ н _ г ы т ы м _ э к в э т _ гъэ _ т _ н э м э _ а м _ ъян _ ра _ 
нотагты гаԓгоратваԓенат нэмэ эԓьувыԓгыкэ ӄуԓиникэк нэмэ	 н о т а _ гты _ г а _  ԓ г о р а _ тва _ ԓена _ т _ н э м э _ э _ ԓьу _  в ы ԓ г ы _  к _ э _ ӄ у ԓ и н и к э _ к _ н э м э _ 
ԓьувыԓгыгъэт нэмэ йынатъёоӈӈонэн ытԓенъютэ умиԓгу нинивӄин ынӈатаԓым	 ԓ ь у _  в ы ԓ г ы _ гъэ _ т _ н э м э _ й ы н _  а т ъ ё о _  ӈ ӈ о _  н э _  н _ ы т ԓ е н _ ъют _ э _ у м и ԓ г у _ н _  и н _ ив _ ӄин _ ы н ӈ а т _ аԓым _ 
эты игыр тыйъогыр умиԓгу нычимгъуӄин нивӄин нинивӄин	 э т ы _ и г ы р _ т ы _  й ъ о _  г ы р _ у м и ԓ г у _ н ы _  ч и м г ъ у _  ӄ и н _ н _ ив _ ӄин _ н _  и н _ ив _ ӄин _ 
ытԓенъютэ умиԓгунэ ивнин вынэ эвыр опопы амыным моогъат	 ы т ԓ е н _ ъют _ э _ у м и ԓ г у _  н э _ и в _ ни _ н _ в ы н э _ э в ы р _ о п о п ы _ а м _ ыным _ м о о _  г ъ а _ т _ 
тэйкэвкы иам нэнагнатъёоӄэн ынээԓьын тутъыԓӄутынэ миӈкыри ӄун	 т э й к э в _  к ы _ и а м _ н _  э н а _  г н а _ т _  ъ ё о _  ӄ э н _ ы н э э ԓ ь ы _ н _ т у т _  ъ ы ԓ ӄ _  у т ы _  н _  э _ м и ӈ _ кы _ ри _ ӄ у н _ 
ытԓён ёргэты ваԓьын чама	 ы т ԓ ё н _ ё р г _ эты _ ва _ ԓьы _ н _ ч а м а _ 
тотъэты ваԓьын ынкъам ынӄэната ынээԓьын нэнагнатӄэн	 т о т _  ъ _ эты _ ва _ ԓьы _ н _ ы н к ъ а м _ ы н ӄ э н а _ та _ ы н э э ԓ ь ы _ н _ н _  э н а _  г н а _ т _ ӄэн _ 
ԓыгэн ӄун ёргэты ваԓьын	 ԓ ы г э н _ ӄ у н _ ё р г _  э т ы _ ва _ ԓьы _ н _ 
аны нинэнтэйкэвэтӄин ынээԓьэ аны ӄэйвэ гэԓгэрмэвӄээтԓин тутъыԓӄутӄэй	 а н ы _ н _  и н э _  н _  т э й к э в _ эт _ ӄин _ ы н э э ԓ ь _ э _ а н ы _ ӄ э й в э _ г э _  ԓ г э _  р м э в _  ӄ э э т _ ԓин _ т у т _  ъ ы ԓ ӄ _  у т _  ӄ э й _ 
рыпэт	 р ы п э т _ 
ӄун нутэсӄын ӄынур ыԓьыԓ 	 ӄ у н _ н у т э _  с _ ӄын _ ӄ ы н у р _ ы _ ԓьы _ ԓ _ _ 
гыткат ӈэнри нунрэпэтӄинэт миԓгунэ	 г ы т к а _ т _ ӈ э н _  р и _ н у н _  р э п э т _  ӄ и н э _ т _ м _  и ԓ г у _  н э _ 
эннэпы эйминнин ынкъам нинэтиӈуткуӄин ыныкаӈӄачагты	 э н н _ эпы _ э й м и н _ ни _ н _ ы н к ъ а м _ н _  и н э _  т _  и ӈ у т к у _  ӄ и н _ ы н ы _  к а _  ӈ ӄ а ч а _ гты _ 
аны ныкытъыматыԓьатӄэн тутъыԓӄут 	 а н ы _ н ы _  к ы _  т _  ъ ы м а т ы _  ԓ ь а т _  ӄ э н _ т у т _  ъ ы ԓ ӄ у т _ _ 
ытԓенъюӄэй ԓюур ръэнут пэгԓягъэ ԓыгэн	 ы т ԓ е н _  ъ ю ӄ э й _ ԓ ю у р _ р ъ э н у т _ п э г ԓ я _  г ъ э _ ԓ ы г э н _ 
эвыр ынкэӄэй пэӄэттатгъэ ытԓеӈи ӄытԓыги ытԓенъюн	 э в ы р _ ы н к э _  ӄ э й _ п э ӄ э т _  т а т _ гъэ _ ы т ԓ е _ ӈи _ ӄ ы т ԓ ы г и _ ы т ԓ е н _  ъ ю _ н _ 
гыткаԓгын рыйыԓгынтэннин аны гакапчачавԓен	 г ы т к а _  ԓ г ы _  н _ р ы _  й ы ԓ _  г ы н т э н _ ни _ н _ а н ы _ г а к а п ч а ч а в _ ԓен _ 
умиԓгу чама гэейвэчетԓин тотъытԓянъёгты ынӄо рырагтаннэн нотайпы	 у м и ԓ г у _ ч а м а _ г э _  е й в э _  ч е т _ ԓин _ т о т ъ ы т ԓ я н ъ ё _  г т ы _ ы н ӄ о _ р ы _  р а _ гт _ ан _ нэ _ н _ н о т а _  й п ы _ 
имтитэ ытԓыгэ пынԓёнэн авъеткынка нытваӄэн умиԓгу ынӄо ытԓеӈи иквъи ынӄо	 и м т и т э _ ы т ԓ ы г _ э _ п ы н ԓ ё _  н э н _ а в ъ е _ ткын _ к _ а _ н ы _ тва _ ӄэн _ у м и ԓ г у _ ы н ӄ о _ ы т ԓ е _ ӈи _ и к _ въ _ и _ ы н ӄ о _ 
ытԓыгын иквъи ынӄо умиԓгу нэмэ эквэтгъи ытԓеӈиым ярак пэԓятгъэ ярак	 ы т ԓ ы г ы _ н _ и к _ въ _ и _ ы н ӄ о _ у м и ԓ г у _ н э м э _ э к в э т _ гъ _ и _ ы т ԓ е ӈ _  и ы м _ я р а _ к _ п э ԓ я _  т _ гъэ _ я р а _ к _ 
гаԓгоратъыԓытваԓен тутъыԓӄут ынӄо мэԓеквъи тутъыԓӄут ԓыгэн эвыр	 г а _  ԓ г о р а _  т ъ ы ԓ ы _  т в а _ ԓен _ т у т _  ъ ы ԓ ӄ у т _ ы н ӄ о _ м э ԓ е к _ въ _ и _ т у т _  ъ ы ԓ ӄ _  у т _ ԓ ы г э н _ э в ы р _ 
эквэтгъи нотагты тутъыԓӄут аны горатваԓен тутъыԓӄут рэрмэвӈык	 э к в э т _ гъ _ и _ н о т а _ гты _ т у т _  ъ ы ԓ ӄ _  у т _ а н ы _ г о р а _ тва _  ԓ е н _ т у т _  ъ ы ԓ ӄ _  у т _ р э р м э в _  ӈ ы к _ 
ӄынвэр нэмэ ԓюур ԓьувыԓгыгъэт гэнээԓьэ ынкы	 ӄ ы н в э р _ н э м э _ ԓ ю у р _ ԓ ь у _  в ы ԓ г ы _ гъэ _  т _ г э _  н э э ԓ ь _ э _ ы н _ кы _ 
ынээԓьын гаԓгэкоргавԓен ынӄо	 ы н э э ԓ ь ы _ н _ г а _  ԓ г э _  к о р г а в _  ԓ е н _ ы н ӄ о _ 
ивнин умиԓгунэ ытԓеӈи ынӄэным	 и в _ ни _ н _ у м и ԓ г у _  н э _ ы т ԓ е _ ӈи _ ы н ӄ э н ы м _ 
виин раԓьонъёно	 в и и н _ р а _  ԓ ь о _  н ъ ё _  н о _ 
мыныԓгын энмэч виин ёпынвыӈаеты	 м ы н ы _  ԓ г ы _ н _ э н м э ч _ в и и н _ ё _  п ы н в ы _  ӈ а _  е т ы _ 
мынытԓепыткусӄивмык ёпынвыӈаеты эквэтгъэт	 м ы н ы _  т _  ԓ е п ы _ тку _ сӄив _  м ы к _ ё _  п ы н в ы _  ӈ а _  е т ы _ э к в э т _  г ъ э _ т _ 
гэтԓенъютэ аны	 г э _  т _  ԓ е н _  ъ ю т _ э _ а н ы _ 
ынкы гапэрӄытваԓенат ёпынвыӈайгэӈкы	 ы н _ кы _ г а _  п э р ӄ ы _ тва _ ԓена _ т _ ё _  п ы н в ы _  ӈ а й _  г э ӈ _ кы _ 
ԓюур рай ӄоԓ	 ԓ ю у р _ р а й _ ӄ о ԓ _ 
ёпыԓӄэвыԓьын ёпынвыӈаеты	 ё п ы ԓ ӄ э в ы _  ԓ ь ы _  н _ ё _  п ы н в ы _  ӈ а _  е т ы _ 
аны ԓыгэн ӄынур йъаяӄ ныԓеӄин наӄам	 а н ы _ ԓ ы г э н _ ӄ ы н у р _ й ъ а _  я _ ӄ _ н ы _  ԓ е _ ӄин _ н а ӄ а м _ 
иԓгиръыԓьын ынӄэн ёпыԓӄэвыԓьын	 и ԓ г и _  р ъ ы _ ԓьы _ н _ ы н ӄ э н _ ё п ы ԓ ӄ э в ы _  ԓ ь ы _ н _ 
торъаатчек туринъытвиԓьын ынӄо ынӄэн	 т о р ъ а а т _  ч е _  к _ т у р и _  н ъ ы _  т в и _  ԓ ь ы _ н _ ы н ӄ о _ ы н ӄ э н _ 
оравэтԓьан кытэӄэй ынкы	 о р а в э т ԓ ь а _ н _ к ы т э _ ӄэй _ ы н _ кы _ 
вагъэ ынӄо эквэтгъи ынӄо нэмэ	 в а _  г ъ _ э _ ы н ӄ о _ э к в э т _ гъ _ и _ ы н ӄ о _ н э м э _ 
ӄоԓ пыкиргъи ёпынвыӈаеты ынраӄ	 ӄ о ԓ _ п ы к и р _ гъ _ и _ ё _  п ы н в ы _  ӈ а _  е т ы _ ы н р а _ ӄ _ 
ытԓенъютэ нинивӄин ынээԓьын нинивӄин умиԓгунэ наӄам мэрынрэӄэй	 ы т ԓ е н _ ъют _ э _ н _  и н _ ив _ ӄин _ ы н э э ԓ ь ы _ н _ н _  и н _ ив _ ӄин _ у м и ԓ г у _  н э _ н а ӄ а м _ м э р ы н р э _ ӄэй _ 
нывэтгавӄэнат ытри нинивӄин ытԓенъютэ ӄынвэр эквэтгъи	 ны _  в э т г а в _  ӄ э н а _ т _ ы т р и _ н _  и н _ ив _ ӄин _ ы т ԓ е н _ ъют _ э _ ӄ ы н в э р _ э к в э т _  г ъ _ и _ 
ԓюур ӄуԓиникэк коԓё пыкитчыӄиквъи оравэтԓьан ӄынур кэйӈын аны	 ԓ ю у р _ ӄ у ԓ и н и к э _ к _ к о ԓ ё _ п ы к и т ч ы ӄ и к _ въ _ и _ о р а в э т ԓ ь а _ н _ ӄ ы н у р _ к э й ӈ ы _ н _ а н ы _ 
ынӄэн ытԓенъюӄэй наӄамԓым ԓыгайыԓгавыԓьатыӈӈой ынӄо ытԓён нивӄин ынӄэн	 ы н ӄ э н _ ы т ԓ е н _  ъ ю ӄ э й _ н а ӄ а м _  ԓ ы м _ ԓ ы г а _  й ы ԓ _  г а в ы _  ԓ ь _  а т ы _ ӈӈо _  й _ ы н ӄ о _ ы т ԓ ё н _ н _ ив _ ӄин _ ы н ӄ э н _ 
умиԓгу аны ытԓеӈи найыԓгавӄэн ытԓенъютэ	 у м и ԓ г у _ а н ы _ ы т ԓ е _ ӈи _ н а _  й ы ԓ _ гав _  ӄ э н _ ы т ԓ е н _ ъют _ э _ 
нинивӄин ынӄо ивнин ытԓеӈи	 н _  и н _ ив _ ӄин _ ы н ӄ о _ и в _ ни _ н _ ы т ԓ е _ ӈи _ 
эвыр рэнанмыгъа гым ынӈэ гыт вэты ӄун урэвкэ ԓыгэн ӄонпы ынкы	 э в ы р _ р э н а _ нмы _ гъа _ г ы м _ ы н ӈ э _ г ы т _ в э т ы _ ӄ у н _ у р э в _ к _ э _ ԓ ы г э н _ ӄ о н п ы _ ы н _ кы _ 
ӄатчытваркын вытку рэквэтгъэ ытԓён ынкы	 ӄ а т ч ы _  т в а _  р к ы н _ в ы т к у _ р э к в э т _ гъэ _ ы т ԓ ё н _ ы н _ кы _ 
вытку ӄэквэтги	 в ы т к у _ ӄ _  э к в э т _ г _ и _ 
ярагты ынкъам ытԓыгын ӄынымӈыԓяквын аны ӈан эчги ёпынвыӈайык	 я р а _  г т ы _ ы н к ъ а м _ ы т ԓ ы г ы _ н _ ӄ ы н ы _  м ӈ ы ԓ я _  к _  в ы _ н _ а н ы _ ӈ а н _ э ч г и _ ё _  п ы н в ы _  ӈ а й ы к _ 
тыттэтгъи танӈармайӈын аны гапэнрыԓен умиԓгунэ ынӄо ԓыгэн	 т ы т т э т _ гъ _ и _ т а н ӈ а _  р _  м а й ӈ ы _  н _ а н ы _ г а _  п э н р ы _ ԓен _ у м и ԓ г у _  н э _ ы н ӄ о _ ԓ ы г э н _ 
эвыр ивнин танӈармайӈа умиԓгу аны гапэнрыԓен умиԓгунэ	 э в ы р _ и в _ ни _ н _ т а н ӈ а _  р _  м а й ӈ а _ у м и ԓ г у _ а н ы _ г а _  п э н р ы _ ԓен _ у м и ԓ г у _  н э _ 
ынӄо ԓыгэн эвыр ивнин танӈармайӈа умиԓгу аны ынраӄ моонэн пынԓёк танӈармайӈа ынӄо ивнин	 ы н ӄ о _ ԓ ы г э н _ э в ы р _ и в _ ни _ н _ т а н ӈ а _  р _  м а й ӈ а _ у м и ԓ г у _ а н ы _ ы н р а _ ӄ _ м о о _  н э _ н _ п ы н ԓ ё _  к _ т а н ӈ а _  р _  м а й _  ӈ а _ ы н ӄ о _ и в _ ни _ н _ 
умиԓгунэ танӈармайӈын чеӈэрым мытԓьувыԓгымык аны гамгоԓенат пойгыԓьатык таӈымъыԓёӈэт	 у м и ԓ г у _  н э _ т а н ӈ а _  р _  м а й ӈ ы _  н _ ч е ӈ _  э р ы м _ м ы т _  ԓ ь у _  в ы _ ԓгы _  м ы к _ а н ы _ г а _  м г о _  ԓ е н а _ т _ п о й г ы _ ԓьа _  т ы к _ т а ӈ _  ы м _ ъыԓё _ ӈэт _ 
гамаравԓенат инъэ моогъат маравкы	 г а _  м а р а в _ ԓена _ т _ и н ъ _ э _ м о о _  г ъ а _ т _ м а р а в _  к ы _ 
наӄам ёпынвыӈайкэн ԓявтыткын ныԓгинычьувӄин эрвъэӈэты ваԓьын таӈымъыԓёӈэт	 н а ӄ а м _ ё _  п ы н в ы _  ӈ а й _  к э н _ ԓ я в т ы _  т к ы н _ н ы _  ԓ г и _ ны _  ч ь у _  в _  ӄ и н _ э р в _  ъ э ӈ _  э т ы _ в а _ ԓьы _ н _ т а ӈ _  ы м _ ъыԓё _ ӈэт _ 
гапойгыԓьатԓенат умиԓгу ытри танӈармачьиӈын ԓюур воԓӄытвэма тэкэм	 г а _  п о й г ы _  ԓ ь а т _  ԓ е н а _ т _ у м и ԓ г у _ ы т р и _ т а н ӈ _  а р м а _ чь _  и ӈ ы _ н _ ԓ ю у р _ в о ԓ ӄ ы _ твэ _  м а _ т э к _ эм _ 
тиркытир нивтытвиӄин ынкы ԓюур почьакагыргык выквагъэ пойгырынрыянвыкэн поӄыткын	 т _  и р к ы т и р _ н _  и в т ы _ тви _ ӄин _ ы н _ кы _ ԓ ю у р _ п о ч ь а _  к а г ы р г ы _ к _ в ы к в а _  г ъ _ э _ п о й г ы _  р ы н р ы я н в ы _  к э н _ п о ӄ ы _ ткын _ 
танӈармачьиӈэн ынӄо ԓыгэн	 т а н ӈ _ арма _  ч ь и _  ӈ э н _ ы н ӄ о _ ԓ ы г э н _ 
эвыр пэӄэттатгъэ ынӄо иквъи энантэнмаквъэ энанмыгъэ энмэч	 э в ы р _ п э ӄ э т _  т а т _ гъэ _ ы н ӄ о _ и к _ въ _ и _ э н а н _  т э н _  м а к _ въ _ э _ э н а _  н м ы _  г ъ э _ э н м э ч _ 
ӄэнатаӈынмыгэ этки танӈыӈавыйӈа гагтойгым	 ӄ _  э н а _  т а _  ӈ _  ы н м ы _  г _ э _ э т _  к _ и _ т а н ӈ ы _  ӈ а в ы й _ ӈа _ г а _  г т о _  й г ы м _ 
майӈыпочьакагыргыԓьо ынӄо тымнэн умиԓгынэ танӈармайӈын ынӄэнына	 м а й ӈ ы _  п о ч ь а _  к а г ы р г ы _  ԓ ь о _ ы н ӄ о _ т ы м _ нэн _ у м и ԓ г ы _  н _  э _ т а н ӈ а _  р _  м а й ӈ ы _ н _ ы н ӄ э н ы _ н _ а _ 
танӈармайӈа танԓымынӄо ниниткэйвыӄинэт ӈэԓвыԓьыт	 т а н ӈ а _  р _  м а й _  ӈ а _ т а н ԓ ы м _ ынӄо _ н _  и н _  и т _  к э й в ы _  ӄ и н э _ т _ ӈ э ԓ в ы _ ԓьы _ т _ 
ынкъам ынанармачьо	 ы н к ъ а м _ ы н а н а р м а _  ч ь о _ 
нитӄин ынӄэнайӈын наӄам ынин маравратчыӈын ныԓгинымкыӄин коԓё ԓыгэгаймычьыԓьыйӈо гатваԓен ынӄэнайӈын миӈкыри ӄун танԓымынӄо гаӄороткоԓьатԓен чама маравтомга нинэпириԓьэтӄинэт ӈочьыткойпы	 н _  и т _ ӄин _ ы н ӄ э н а _  й ӈ ы _ н _ н а ӄ а м _ ы н _  и н _ м а р а в р а _  т ч ы _  ӈ ы _ н _ н ы _ ԓги _ ны _  м к ы _ ӄин _ к о ԓ ё _ ԓ ы г э _  г _ аймы _ чьы _  ԓ ь ы _  й ӈ о _ г а _ тва _ ԓен _ ы н ӄ э н а _  й ӈ ы _ н _ м и ӈ _ кы _ ри _ ӄ у н _ т а н ԓ ы м _ ынӄо _ г а _  ӄ о р о _  т к о _  ԓ ь а т _  ԓ е н _ ч а м а _ м а р а в _  т о м г _ а _ н _ инэ _  п и р и _  ԓ ь э т _  ӄ и н э _ т _ ӈ о ч ь ы _  т к о _  й п ы _ 
ачак ынӄэнына ганмыԓен умиԓгуӄэйынэ аны ынӄэн ынкы пойгыԓьанма	 а ч а _ к _ ы н ӄ э н ы _ н _ а _ г а _  н м ы _ ԓен _ у м и ԓ г у _  ӄ э й _  ы н _  э _ а н ы _ ы н ӄ э н _ ы н _ кы _ п о й г ы _  ԓ ь а _  н _  м а _ 
ымъыԓёӈэт гапаӈъэватычгатԓен	 ы м _ ъыԓё _ ӈэт _ г а _  п а ӈ ъ э в _  а т ы _  ч г _ ат _ ԓен _ 
танӈармачьын энмэч еԓычгын ганточгатԓен ныкэнчиӄыткуӄин	 т а н ӈ _ арма _  ч ь ы _ н _ э н м э ч _ е ԓ ы ч г ы _ н _ г а _  н т о _  ч г _ ат _ ԓен _ н ы _  к э н _  ч и ӄ ы _ тку _  ӄ и н _ 
ынӄо йъонэн ивтыԓ	 ы н ӄ о _ й ъ о _ нэ _ н _ и в т ы ԓ _ 
ваԓьын ытԓеӈи ынӄо ивнин ынинэԓьэ	 в а _  ԓ ь ы _ н _ ы т ԓ е _ ӈи _ ы н ӄ о _ и в _ ни _ н _ ы н и н э _ ԓь _ э _ 
ынӄо	 ы н ӄ о _ 
рагтыгъат гэнээԓьэ	 р а _  г т ы _ гъа _ т _ г э _  н э э ԓ ь _ э _ 
ынкы ӄэйыӄын паӈъэвӈытотвагъат гэтԓенъютэ ынӄо	 ы н _ кы _ ӄ э й ы ӄ ы _ н _ п а ӈ ъ э в _ ӈыто _  т в а _  г ъ а _ т _ г э _  т _  ԓ е н _  ъ ю т _ э _ ы н ӄ о _ 
эквэтгъэт	 э к в э т _  г ъ э _ т _ 
ны ынраӄ ынкы ныԓӄырирӄинэт ыргинэт	 ны _ ы н р а _ ӄ _ ы н _ кы _ н ы _  ԓ ӄ ы р и р _  ӄ и н э _ т _ ы р г и _ нэ _ т _ 
йъэԓгытомгыт ынкъам	 й ъ э _ ԓгытомгы _  т _ ы н к ъ а м _ 
ӄынвэр нэԓьунэт	 ӄ ы н в э р _ н э _  ԓ ь у _  н э _ т _ 
ыннэн йъэԓгытомгын ныԓгэнымԓыӄэн	 ы н н э н _ й ъ э _  ԓ г ы т о м г ы _ н _ н ы _  ԓ г э _ ны _ мԓы _ ӄэн _ 
ыниным нынны пэрӄыё ыргиным гыттэпычьын	 ы н и _ ным _ н ы н н ы _ п э р ӄ ы _  ё _ ы р г и _  н ы м _ г ы т _  т э п ы _ чьы _ н _ 
нытваӄэн ымы	 ны _  т в а _ ӄэн _ ы м ы _ 
ӄытԓыги энмэч ынин нынны вэтгавчьомыԓьо ытри	 ӄ ы т ԓ ы г и _ э н м э ч _ ы н _  и н _ н ы н н ы _ в э т г а в _  ч ь о _  м ы ԓ ь о _ ы т р и _ 
нытваӄэнат эннысӄыткынык пыкиргъэт ынкы ԓыгэн эвыр эԓкыԓнинэт вэтгавчьомыԓьона ытԓывъёт	 ны _  т в а _  ӄ э н а _ т _ э н _  н ы _  с ӄ ы _  т к ы н ы _ к _ п ы к и р _  г ъ э _ т _ ы н _ кы _ ԓ ы г э н _ э в ы р _ э ԓ к ы ԓ _ ни _  н э _ т _ в э т г а в _  ч ь о _  м ы ԓ ь о _  н _  а _ ы т ԓ ы в ъ ё _  т _ 
ивнинэт ынӄо ивнинэт вэтгавчьомыԓьона	 и в _ ни _  н э _ т _ ы н ӄ о _ и в _ ни _  н э _ т _ в э т г а в _  ч ь о _  м ы ԓ ь о _  н _  а _ 
энмэч пэтԓе рэпкирӈыт	 э н м э ч _ п э т ԓ _ е _ р э _  п к и р _  ӈ ы _  т _ 
рынноԓьыт аны ынкы	 р ы н н о ԓ ь ы _ т _ а н ы _ ы н _ кы _ 
гатэнмавԓенат маравынвэты ымы	 г а _  т э _ нм _ ав _  ԓ е н а _ т _ м а р а в ы н в э т ы _ ы м ы _ 
ынӄэн пэрӄыён томгымкычгын опопы гым виин ёпынвыӈаеты мыёпыԓӄэвык эквэтгъи	 ы н ӄ э н _ п э р ӄ ы ё _  н _ т о м г ы _  м к ы ч г ы _ н _ о п о п ы _ г ы м _ в и и н _ ё _  п ы н в ы _  ӈ а _  е т ы _ м ы ё _  п ы ԓ ӄ _  э в ы _  к _ э к в э т _  г ъ _ и _ 
умиԓгу ёпыԓӄэвынвэты аны	 у м и ԓ г у _ ё п ы ԓ ӄ _  э в ы н в э т ы _ а н ы _ 
ёпынвыӈайыткынык гаёпытваԓен ԓюур рай тэкэм тэркэвтытвэма мооԓьычгын ӈоонӄо ининигъи ынкы атчыгъэ тумгэӄэй	 ё _  п ы н в ы _  ӈ а й _  ы _  т к ы н ы _ к _ г а _  ё _  п ы т в а _ ԓен _ ԓ ю у р _ р а й _ т э к _ эм _ т э р к э в _  т ы _  т в э _  м а _ м о о _  ԓ ь ы _  ч г ы _ н _ ӈ о о н _  ӄ о _ и н _ ини _ гъ _ и _ ы н _ кы _ а т ч ы _ гъэ _ т у м г э _ ӄэй _ 
умиԓгу ԓюур ынкы тэкэм	 у м и ԓ г у _ ԓ ю у р _ ы н _ кы _ т э к _ эм _ 
ёпынвыӈайык ӄача вуԓӄытвининэт	 ё _  п ы н в ы _  ӈ а й ы к _ ӄ а ч а _ в у ԓ ӄ ы _ тви _  н и _  н э _ т _ 
мууԓьыт нкы гаманэгранпатԓенат ынӄо эчги тэӈвуԓӄытвигъи ӄытгъи манэграԓьэты аны	 м у у _  ԓ ь ы _ т _ н _  к ы _ г а _  м а н э г р а _  н _  п а т _  ԓ е н а _ т _ ы н ӄ о _ э ч г и _ т э ӈ _  в у ԓ ӄ ы _ тви _  г ъ _ и _ ӄ ы т _ гъ _ и _ м а н э _  г р а _  ԓ ь _ эты _ а н ы _ 
умиԓгунэ гачамэттаԓенат манэграԓьыт ӄынвэр пыкиргъи манэграԓьык	 у м и ԓ г у _  н э _ г а _  ч а м э т т а _ ԓена _ т _ м а н э _  г р а _  ԓ ь ы _  т _ ӄ ы н в э р _ п ы к и р _  г ъ _ и _ м а н э _  г р а _  ԓ ь ы _  к _ 
винвэӄэй ԓюнԓьутэ нынтыӄин эӄэԓьэ ԓюур ынкы вэнвыпаԓёмтэԓгъэ манэграгэӈкы ынкы нивӄинэт	 в и н в э _ ӄэй _ ԓ ю н ԓ ь у _ т _ э _ н ы _ нты _  ӄ и н _ э _  ӄ э ԓ _ ь _ э _ ԓ ю у р _ ы н _ кы _ в э н в ы _  п а ԓ ё _  м т э ԓ _  г ъ _  э _ м а н э _  г р а _  г э ӈ _  к ы _ ы н _ кы _ н _  и в _  ӄ и н э _ т _ 
ытри амыным атав игыр ныкитэ мынчамэттанат умиԓгун	 ы т р и _ а м _  ы н ы м _ а т а в _ и г ы р _ н ы _  к и т _ э _ м ы н _  ч а м э т т а _  н а _ т _ у м и ԓ г у н _ 
рэмкын ынӄэнат рынноԓьыт омэԓгона миӈкыри	 р э м к ы _ н _ ы н ӄ э н а _  т _ р ы н н о ԓ ь ы _ т _ о м э ԓ г о _  н а _ м и ӈ _ кы _ ри _ 
ӄун ынан ганмыԓен ыргин ынанармачьын танӈармайӈын эчгиым ынӈин ивыпԓыткугъэт	 ӄ у н _ ы н а н _ г а _  н м ы _ ԓен _ ы р г и н _ ы н а н а р м а _  ч ь ы _  н _ т а н ӈ а _  р _  м а й ӈ ы _ н _ э ч г и _  ы м _ ы н ӈ и н _ и в ы _ пԓытку _  г ъ э _ т _ 
эӄэԓьыт винвэӄэй	 э _  ӄ э ԓ ь ы _ т _ в и н в э _  ӄ э й _ 
эквэтгъи	 э к в э т _ гъ _ и _ 
ярагты ынӄо яраԓьыт	 я р а _  г т ы _ ы н ӄ о _ я р а _  ԓ ь ы _  т _ 
ивнинэт миӈкъым ԓьунэт эӄэԓьыт	 и в _ ни _  н э _ т _ м и ӈ _  к _ ъым _ ԓ ь у _  н э _  т _ э _ ӄэԓьы _ т _ 
ынӄо вэтгавчьомыԓьо иквъи	 ы н ӄ о _ в э т г а в _  ч ь о _  м ы ԓ ь о _ и к _ въ _ и _ 
ӄуттиым пытӄырымагты	 ӄ у т _ ти _ ым _ п ы т ӄ ы р ы м а _  г т ы _ 
натчынат	 н а _  т ч ы н а _  т _ 
ӈаԓгыԓ ӄэнъевык гаԓгатчыръоԓенат	 ӈ а ԓ _ гыԓ _ ӄ э н ъ е в ы _  к _ г а _  ԓ г а _  т ч ы _  р ъ о _ ԓена _ т _ 
гъыттъыма аны ԓюур нымгутыԓеӄинэт	 г _  ъ ы т т _  ъ ы м _  а _ а н ы _ ԓ ю у р _ н ы м г у т ы ԓ е _ ӄинэ _ т _ 
вусӄымчыку коԓё ныԓгинымэйыӈӄин мооԓьиӈын ныԓеӄин ӄанъявэчгэтты ԓюур эчги	 в у с ӄ ы м _ чыку _ к о ԓ ё _ н ы _ ԓги _ ны _  м э й ы ӈ _  ӄ и н _ м о о _ ԓь _  и ӈ ы _ н _ н ы _  ԓ е _ ӄин _ ӄ а н ъ я в э _  ч г э _  т т ы _ ԓ ю у р _ э ч г и _ 
ынанэвтыԓяӈӄач ваԓьакы мачгаԓяк ивтытԓьэтэ нъыттъытриԓынэт аны гиинъыттъыт гапэнрыткоԓенат	 ы н а н э в _  т ы ԓ я _  ӈ ӄ а ч _ в а _  ԓ ь а _  к ы _ м а ч _  г а ԓ я _ к _ и в т ы т ԓ ь э т _  э _ н _  ъ ы т т ъ ы т _  р и ԓ ы _  н э _ т _ а н ы _ г _  и и н ъ ы т т ъ ы _  т _ г а _  п э н р ы _ тко _ ԓена _ т _ 
моогты аны	 м о о _  г т ы _ а н ы _ 
гэръиԓеԓин мооԓьыйӈын ораыттъыёԓягты ынӄо	 г э _  р ъ и ԓ е _ ԓин _ м о о _  ԓ ь ы _  й ӈ ы _ н _ о р а ы т _  т ъ ы ё ԓ я _ гты _ ы н ӄ о _ 
намгогъан танԓымынӄо ыттъытриԓьюук аны	 н а м г о _  г ъ а _ н _ т а н ԓ ы м _ ынӄо _ ы т т ъ ы т _  р и ԓ ь ю у _  к _ а н ы _ 
ыттъыт гаӄоԓема	 ы т т ъ ы _  т _ г а _  ӄ о ԓ е _ ма _ 
гапэнрыткоръоԓенат	 г а _  п э н р ы _ тко _  р ъ о _ ԓена _ т _ 
ынкы мууриԓ гэкымъугчитԓин чинит ирвык	 ы н _ кы _ м у у р и ԓ _ г э _  к ы м ъ у _  г _  ч и т _ ԓин _ ч и н и т _ и р в ы _  к _ 
ӄэтвэтръугъэт таӈымыԓьо эвыр эквырга чымӄык гэегтэтԓинэт ынӄэнат ыргынан нэпиринэт маравтомго ынӄо нымытваӈӈогьат	 ӄ э т в э т _  р ъ у _  г ъ э _ т _ т а ӈ _ ымыԓьо _ э в ы р _ э к _ вырга _ ч ы м ӄ ы _ к _ г э _  е г т _ эт _  ԓ и н э _ т _ ы н ӄ э н а _ т _ ы р г ы _ нан _ н э _  п и р и _ нэ _ т _ м а р а в _  т о м г о _ ы н ӄ о _ н ы _  м ы т в а _  ӈ ӈ о _  г ь а _  т _ 
рымагтэты таӈӄонпы ытри	 р ы _  м а г т _ эты _ т а ӈ _  ӄ о н п ы _ ы т р и _ 
нотагты ӄытыԓьэтыԓьыт пэниннэт рачвыӈыԓьыт с ӈаԓвыԓьиӈын	 н о т а _ гты _ ӄ ы т ы _  ԓ ь _  э т ы _  ԓ ь ы _ т _ п э н и н _  н э _  т _ р а ч в ы ӈ ы _ ԓьы _ т _ с _ ӈ а ԓ в ы _ ԓь _  и ӈ ы _ н _ 
ыргин аръаԓя ныԓгинымкыӄин рыпэт	 ы р г и н _ а р ъ а ԓ я _ н ы _  ԓ г и _ ны _  м к ы _ ӄин _ р ы п э т _ 
ынанчинит ԓейвэ	 ы н а н _  ч и н и т _ ԓ е й в э _ 
итыԓьын энмэн ганымытваԓенат тэӈыннэнчеэкэй	 и т ы _  ԓ ь ы _ н _ э н м э н _ г а _  н ы _ мытва _ ԓена _ т _ т э ӈ _  ы н н э н _  ч е э _ кэй _ 
чавчывамкиӈын ԓыгэн	 ч а в ч ы в а _  м к и ӈ ы _  н _ ԓ ы г э н _ 
ӄун	 ӄ у н _ 
ныԓгинымкыӄин рагэнэвчыӈын	 ны _  ԓ г и _ ны _  м к ы _ ӄин _ р а г э _  н _  э в ч ы _  ӈ ы _  н _ 
ӈаԓвыԓьиӈын ыргин аръаԓя ныԓгинымкыӄин	 ӈ а ԓ в ы _ ԓь _ иӈы _ н _ ы р г и н _ а р ъ а ԓ я _ н ы _  ԓ г и _ ны _  м к ы _ ӄин _ 
рыпэт ынанчинит ԓейвэ итыԓьын	 р ы п э т _ ы н а н _  ч и н и т _ ԓ е й в э _ и т ы _  ԓ ь ы _  н _ 
аны отчой ганымытваԓенат ынӄэнат	 а н ы _ о т ч о _ й _ г а _  н ы _ мытва _ ԓена _ т _ ы н ӄ э н а _ т _ 
рамкиӈын ынраӄ ӄоԓ гатваԓен ынин нынны мотԓынто ынӄэн оравэтԓьан энмэч рэтинэнъэӄэӈгъэ ӄоԓ итык вуԓӄытвик гараеквэԓен мотԓынто ԓыгэн	 р а _  м к и ӈ ы _ н _ ы н р а _ ӄ _ ӄ о ԓ _ г а _  т в а _ ԓен _ ы н _  и н _ н ы н н ы _ м о т ԓ ы н т о _ ы н ӄ э н _ о р а в э т ԓ ь а _ н _ э н м э ч _ р э т и _  н э _  н ъ э ӄ _  э ӈ _  г ъ э _ ӄ о ԓ _ и т ы _ к _ в у ԓ ӄ ы _ тви _ к _ г а _  р а _  е к в э _  ԓ е н _ м о т ԓ ы н т о _ ԓ ы г э н _ 
танъямгарайпы ныпаԓёмтэԓгэԓеӄэн ԓюур	 т а н ъ я м г а _  р а _  й п ы _ н ы _  п а ԓ ё _ мтэ _ ԓгэ _  ԓ е _  ӄ э н _ ԓ ю у р _ 
ӄоԓераӄайык паԓёмтэԓгъэ тэкэм ынраӄ	 ӄ о ԓ е р а _  ӄ а й _  ы к _ п а ԓ ё м _ тэԓ _ гъ _ э _ т э к _ эм _ ы н р а _  ӄ _ 
ӈъочьыраӄайык эвын ынкы ыргин	 ӈ ъ о ч ь ы _  р а _  ӄ а й _ ык _ э в ы н _ ы н _ кы _ ы р г и н _ 
ытԓыгын нэмыӄэй нытваӄэн ныпавӄэнат	 ы т ԓ ы г ы _ н _ н э м ы ӄ э й _ н ы _  т в а _ ӄэн _ н ы _  п а в _ ӄэна _ т _ 
ӈирэӄ ӈъочьыӈэнӄайӄагтэ ӈан ӄаамотԓя	 ӈ и р э ӄ _ ӈ ъ о _ чьы _  ӈ э н _  ӄ а й _  ӄ а г _ тэ _ ӈ а н _ ӄ а а м о т ԓ я _ 
вуԓӄытвик наӄам ынӄэн ыргин ытԓыгын	 в у ԓ ӄ ы _ тви _ к _ н а ӄ а м _ ы н ӄ э н _ ы р г и н _ ы т ԓ ы г ы _ н _ 
ӈъочьо гитԓин тъарӄааԓьо ԓюур вай мотԓынто	 ӈ ъ о _  ч ь о _ г _  и т _ ԓин _ т ъ а р _  ӄ а а _  ԓ ь о _ ԓ ю у р _ в а й _ м о т ԓ ы н т о _ 
рагтыгъэ ынкъам	 р а _  г т ы _  г ъ э _ ы н к ъ а м _ 
яраԓьыт ивнинэт тав эӄыԓпэ мынынръэйвэвын мургин яраӈы ынкъам мынгынтэв нотаӄаԓеты эӄыԓпэ	 я р а _  ԓ ь ы _  т _ и в _ ни _  н э _ т _ т а в _ э ӄ ы ԓ п э _ м ы н ы _  н _  р ъ э й в _  э в ы _  н _ м у р г _ ин _ я р а _ ӈы _ ы н к ъ а м _ м ы н _  г ы н т э в _ н о т а _  ӄ а ԓ _  е т ы _ э ӄ ы ԓ п э _ 
нэнръэйвэвын яраӈы ынраӄ нэчвиркын чымӄык ӈэԓвыԓ	 н э _  н _  р ъ э й в _ эвы _ н _ я р а _ ӈы _ ы н р а _  ӄ _ н э _  ч в и _  р к ы н _ ч ы м ӄ ы _ к _ ӈ э ԓ в ы ԓ _ 
ԓыгэӄыԓпэ нэчвигъэн ӈэԓвыԓ мачамчымӈы ынӄо гэмгутыԓеԓинэт ԓыгэн	 ԓ ы г _  э ӄ ы ԓ п э _ н э _  ч в и _  г ъ э _ н _ ӈ э ԓ в ы ԓ _ м а ч а _  м ч ы _  м ӈ ы _ ы н ӄ о _ г э _  м г у _  т ы ԓ е _  ԓ и н э _ т _ ԓ ы г э н _ 
нотаӄаԓеты киткитым анымкычаӈэты ӄэйыӄын	 н о т а _  ӄ а ԓ _  е т ы _ к и т к и _ тым _ а н ы _  м к ы _  ч а ӈ _  э т ы _ ӄ э й ы ӄ ы _ н _ 
ынкы гатчытваԓен мотԓынто эчги	 ы н _ кы _ г а _  т ч ы _  т в а _  ԓ е н _ м о т ԓ ы н т о _ э ч г и _ 
эмгынунныкитэ нъэԓгъи	 э м _  г ы н у н _ ны _ кит _ э _ н _  ъ э ԓ _ гъ _ и _ 
тумгэӄэй мотԓынтоӄай гаваӈэйпаратԓен гамгарайпы	 т у м г э _ ӄэй _ м о т ԓ ы н т о _  ӄ а й _ г а _  в а ӈ э й _  п а р а _  т _  ԓ е н _ г а _  м г а р а _  й п ы _ 
нивӄин ик энмэн рэмкын	 н _  и в _ ӄин _ и _ к _ э н м э н _ р э м к ы _ н _ 
вай ӄорачетыркын нивӄинэт	 в а й _ ӄ о р а _  ч е т ы _  р к ы н _ н _ ив _  ӄ и н э _ т _ 
энараԓьыт мургинэт ӄутти	 э н а р а _  ԓ ь ы _ т _ м у р г _  и н э _ т _ ӄ у т _ ти _ 
ик амын	 и _ к _ а м _  ы н _ 
ивкэ мыниткэчитыркын ӈэԓвыԓ ӄытԓыгиым ынӄэн	 и в _  к _ э _ м ы н _  и т _  к э _  ч и т ы _  р к ы н _ ӈ э ԓ в ы ԓ _ ӄ ы т ԓ ы г и _  ы м _ ы н ӄ э н _ 
гъыръунтэтԓин мотԓынто аны	 г _  ъ ы р ъ у н т _ эт _ ԓин _ м о т ԓ ы н т о _ а н ы _ 
ынкы турӄуԓиԓьыръук мотԓынто	 ы н _ кы _ т у р ӄ у ԓ и _  ԓ ь ы _  р ъ у _  к _ м о т ԓ ы н т о _ 
гэԓӄутръуԓинэт гамгараеквэйӈын ԓыгэн ӈытоԓьын гапойгыма нынторъоӄэнат	 г э _  ԓ ӄ у т _  р ъ у _  ԓ и н э _ т _ г а _  м г а р а _  е к в э _  й ӈ ы _ н _ ԓ ы г э н _ ӈ ы т о _  ԓ ь ы _ н _ г а _  п о _ йгым _ а _ н ы _  н т о _  р ъ о _ ӄэна _ т _ 
чиӈивэӄ гатэӈорма ынкы нымэйыӈӄин майӈымарав гатваԓен ԓыгэӄыԓпэ	 ч и ӈ и _  в э ӄ _ г а _  т э ӈ _  о р м _  а _ ы н _ кы _ н ы _  м э й ы ӈ _  ӄ и н _ м а й ӈ ы _  м а р а в _ г а _  т в а _  ԓ е н _ ԓ ы г _  э ӄ ы ԓ п э _ 
нэчвиткуйвын ӈаԓвыԓьиӈын ԓыгэн ӄун тымӈэнӈэн	 н э _  ч в и _  т к у _  й в ы _ н _ ӈ а ԓ в ы _  ԓ ь _ иӈы _ н _ ԓ ы г э н _ ӄ у н _ т ы м ӈ э н _  ӈ э н _ 
нытымӈэчвэткойвыӄэн чымӄыкым ԓыгэн оравэтԓьат нынмыткойвыӄэнат ынкы	 ны _  т ы м ӈ э ч в э _  т к о _  й в ы _  ӄ э н _ ч ы м ӄ ы _  к ы м _ ԓ ы г э н _ о р а в э т ԓ ь а _  т _ н ы _  н м ы _  т к о _  й в ы _ ӄэна _ т _ ы н _ кы _ 
 ԓыгэн ӄаачыко	 _ ԓ ы г э н _ ӄ а а _  ч ы к о _ 
ԓымӈэ ярак ӄача ӄынвэр тэӈуйӈэ	 ԓ ы м _ ӈэ _ я р а _ к _ ӄ а ч а _ ӄ ы н в э р _ т э ӈ _  у й ӈ э _ 
нъэԓгъи арака эвыр	 н _  ъ э ԓ _ гъ _ и _ а р а _  к _  а _ э в ы р _ 
ӈэԓвыԓ тэӈыннэн ԓёӈпэԓята итгъи ӄораӈы вачаӄым ӄытԓыги ынкы ӄоԓ гапэԓятԓен	 ӈ э ԓ в ы ԓ _ т э ӈ _  ы н н э н _ ԓ ё ӈ _  п э ԓ я _ та _ и т _ гъ _ и _ ӄ о р а _ ӈы _ в а ч а _ ӄым _ ӄ ы т ԓ ы г и _ ы н _ кы _ ӄ о ԓ _ г а _  п э ԓ я _  т _ ԓен _ 
яраӈы раԓӄаӈынвык аны ӄынур пырӄаквыԓгын гэтэйкыԓин гаԓгэнъомравԓен аӄанчемавкы ваԓьын	 я р а _  ӈ ы _ р а ԓ _ ӄа _ ӈынвы _ к _ а н ы _ ӄ ы н у р _ п ы р ӄ а к _  в ы _  ԓ г ы _ н _ г э _  т э й к ы _ ԓин _ г а _ ԓгэ _  н ъ о м р а в _  ԓ е н _ а _  ӄ а н _  ч е м а в _ кы _ в а _ ԓьы _ н _ 
ӄытԓыги ынкы ӈирэӄ оравэтԓьат	 ӄ ы т ԓ ы г и _ ы н _ кы _ ӈ и р э ӄ _ о р а в э т ԓ ь а _  т _ 
гэтуйвынԓинэт гэӈээккэтэ ԓюур	 г э _  т у й в ы _  н _  ԓ и н э _ т _ г э _  ӈ э _  э к к э _  т э _ ԓ ю у р _ 
пыкиргъи этратчыӈын рыркаӈэԓгиӈа	 п ы к и р _ гъ _ и _ э т р а _  т ч ы _  ӈ ы _ н _ р ы р к а _  ӈ э ԓ г и _  ӈ а _ 
нъэԓгынтакаӈатын ынӄэн яраӈы натаӈыԓвавын	 н ъ _  э ԓ г ы н т а к а ӈ _  а т ы _  н _ ы н ӄ э н _ я р а _  ӈ ы _ н а т а _  ӈ ы ԓ в а _ вы _ н _ 
рыпирӄык ымы ынраӄ намгон	 р ы _  п и р ӄ ы _  к _ ы м ы _ ы н р а _ ӄ _ н а м г о _  н _ 
ивкы ынкы рыйигрывъэтэ	 и в _  к ы _ ы н _ кы _ р ы й _  и г р ы _  в ъ э т _  э _ 
мытрэнтыгыт ынпыначгыӄай ночыткоӄэн ынӄо высӄу нытчыӄин ынӄо нэмэ иквъэт ынпыначгыӄай	 м ы т _  р э _  н т ы _  г ы т _ ы н п ы н а ч г ы _  ӄ а й _ н о ч ы _ тко _ ӄэн _ ы н ӄ о _ в ы с ӄ у _ н ы _  т ч ы _  ӄ и н _ ы н ӄ о _ н э м э _ и к _  в ъ э _ т _ ы н п ы н а ч г ы _  ӄ а й _ 
нивӄин гымнин йъэԓгытомгыт таӈатӄэԓгычайвыркыт ытръэч тэӈӄырым	 н _  и в _ ӄин _ г ы м _  н и н _ й ъ э _  ԓ г ы т о м г ы _  т _ т а ӈ _  а т ӄ _  э ԓ г ы _  ч а й в ы _  р к ы _ т _ ы т р ъ э ч _ т э ӈ _  ӄ ы р ы м _ 
ӄыԓьугыткы ынӄо ытри	 ӄ ы _  ԓ ь у _ гы _  т к ы _ ы н ӄ о _ ы т р и _ 
иквъэт ынин варкыт эвыӈан йъэԓгытомгыт ынраӄым	 и к _  в ъ э _ т _ ы н _  и н _ в а р к ы _ т _ э в ы _  ӈ а н _ й ъ э _  ԓ г ы т о м г ы _  т _ ы н р а _  ӄ ы м _ 
ръэмиӈкы кытъаткэ ынӄо эквэтгъэт ӄырэрынво ынӄэн ынӄэнат	 р ъ э _  м и ӈ _ кы _ к ы т ъ а т _ к _ э _ ы н ӄ о _ э к в э т _  г ъ э _ т _ ӄ ы р э _  р ы н в о _ ы н ӄ э н _ ы н ӄ э н а _  т _ 
ынӄэнатым гэӈээккэтэ нымытваӈӈогъат ынкы ӄынвэр ӄоԓ	 ы н ӄ э н а _  т ы м _ г э _  ӈ э _  э к к э _  т э _ н ы _  м ы т в а _  ӈ ӈ о _ гъа _ т _ ы н _ кы _ ӄ ы н в э р _ ӄ о ԓ _ 
итык вуԓӄытвик иквъи ынпыначгыӄай ӈааккагты ынӄо ынпыначгыӄая ԓёнтатԓыӈа	 и т ы _ к _ в у ԓ ӄ ы _ тви _ к _ и к _ въ _ и _ ы н п ы н а ч г ы _  ӄ а й _ ӈ а _ акка _ гты _ ы н ӄ о _ ы н п ы н а ч г ы _  ӄ а я _ ԓ ё н т а _  т ԓ ы _  ӈ а _ 
рыннин ытръэч ивнин гэквэтԓинэт ԓыгэн ынӈин высӄумчыку наӄам ԓыгэн ныԓгитымгыпиӈэтӄин ныпыӈкытԓетӄин аны котчой	 р ы н _ нин _ ы т р ъ э ч _ и в _ ни _ н _ г _  э к в э т _  ԓ и н э _ т _ ԓ ы г э н _ ы н ӈ и н _ в ы с ӄ у м _ чыку _ н а ӄ а м _ ԓ ы г э н _ н ы _ ԓги _  т ы м г ы _  п и ӈ э т _ ӄин _ н ы _  п ы ӈ _  к ы т ԓ е т _  ӄ и н _ а н ы _ к о т ч о _  й _ 
гэԓеԓинэт ԓыгэн нотагты наӄам	 г э _  ԓ е _  ԓ и н э _ т _ ԓ ы г э н _ н о т а _  г т ы _ н а ӄ а м _ 
ынпыначгыӄай ныянотыԓьатӄэн ӈээккэтэ	 ы н п ы н а ч г ы _  ӄ а й _ н ы _  я н о т ы _ ԓьат _ ӄэн _ ӈ э _ эккэ _  т э _ 
наӄам	 н а ӄ а м _ 
гэмо миӈкыри тыԓеркыт ԓюур	 г э _  м о _ м и ӈ _ кы _ ри _ т ы ԓ е _  р к ы _ т _ ԓ ю у р _ 
вай янотыԓьын	 в а й _ я н о т ы _ ԓьы _ н _ 
ръэгъи нэмыӄэй ытԓён	 р ъ э _  г ъ _ и _ н э м ы ӄ э й _ ы т ԓ ё н _ 
гэмо ԓыгнин ынан	 г э _  м о _ ԓ ы г _ ни _ н _ ы н а н _ 
ӈэвысӄэтэ эвын ԓыԓепгъи	 ӈ э в ы с ӄ э т _  э _ э в ы н _ ԓ ы ԓ е п _ гъ _ и _ 
 ӄытԓыги энмэпы	 _ ӄ ы т ԓ ы г и _ э н м э п ы _ 
гэкэмчичьэтԓинэт ынпыначгыӄай	 г э к э _  м ч и _  ч ь э т _  ԓ и н э _ т _ ы н п ы н а ч г ы _  ӄ а й _ 
йъонэн ӈээккэтэ 	 й ъ о _ нэ _ н _ ӈ э _ эккэ _  т э _ _ 
эвын гэтъымымчеткуԓьэтԓин ынпыначгыӄай иквъи эвыр	 э в ы н _ г э _  т ъ ы _  м ы м ч _  е _  т к у _  ԓ ь э т _ ԓин _ ы н п ы н а ч г ы _  ӄ а й _ и к _ въ _ и _ э в ы р _ 
ӈэнку рэпкиргъэ	 ӈ э н _ ку _ р э _  п к и р _ гъ _ э _ 
ӄымӈыԓтэԓгэ каракэгты ымыԓьо вагыргын ӄытвыԓьатгын нкъам ынан	 ӄ ы м ӈ ы ԓ _  т э _  ԓ г э _ к а р а _  к э _ гты _ ы м ы ԓ ь о _ в а г ы р г ы _ н _ ӄ ы т в ы _  ԓ ь а т _  г ы _ н _ н к ъ а м _ ы н а н _ 
авык ыргынан ӄонпы нэрэтчыгыт таԓвапаԓӄаттагнэты ээ энмэч	 а в ы к _ ы р г ы _ нан _ ӄ о н п ы _ н э _  р э _  т ч ы _ гыт _ т а ԓ в а _  п а ԓ ӄ _ ат _  т а г н _ эты _ э э _ э н м э ч _ 
гым ԓымӈэ рымагтэты	 г ы м _ ԓ ы м _ ӈэ _ р ы _ магт _ эты _ 
аӄаягтаԓы тытваркын ԓыгэн ынӈин ивыпԓыткук въигъи ынпыначгыӄай	 а _  ӄ а я _ гтаԓы _ т ы _  т в а _  р к ы н _ ԓ ы г э н _ ы н ӈ и н _ и в ы _ пԓытку _ к _ в ъ и г _ ъ _ и _ ы н п ы н а ч г ы _  ӄ а й _ 
миӈкыри ӄун ԓымӈэ ӄэйвэ аӄаягтаԓы эвын	 м и ӈ _ кы _ ри _ ӄун _ ԓ ы м _ ӈэ _ ӄ э й в э _ а _  ӄ а я _ гтаԓы _ э в ы н _ 
миӈкы гэԓгитъымымчеткуԓин ээ	 м и ӈ _ кы _ г э _  ԓ г и _  т ъ ы _  м ы м ч _  е _  т к у _ ԓин _ э э _ 
ынӄэным амынан нъэԓгъи	 ы н ӄ э н ы м _ а м _  ы н а н _ н _  ъ э ԓ _ гъ _ и _ 
ӈэвысӄэт наӄам	 ӈ э в ы с ӄ э т _ н а ӄ а м _ 
ытԓыгын въигъи ытԓёным рыгъеватыԓӄаӈынвыгъет атав эквэтгъи аны	 ы т ԓ ы г ы _ н _ в ъ и г _ ъ _ и _ ы т ԓ ё н ы м _ р ы _  г ъ е в _  а т ы ԓ ӄ а _  ӈ ы н в ы _  г ъ е _ т _ а т а в _ э к в э т _ гъ _ и _ а н ы _ 
котчой гэԓеԓин ӄооӈ ԓыгэн гэмо	 к о т ч о _  й _ г э _  ԓ е _ ԓин _ ӄ о о ӈ _ ԓ ы г э н _ г э _  м о _ 
миӈкыри ӄынвэр вай ԓюур оравэтԓьан ӈытоԓьын ԓьунин ӈэвысӄэтэ ԓыгэным ынӄэн	 м и ӈ _ кы _ ри _ ӄ ы н в э р _ в а й _ ԓ ю у р _ о р а в э т ԓ ь а _ н _ ӈ ы т о _  ԓ ь ы _ н _ ԓ ь у _ ни _ н _ ӈ э в ы с ӄ э т _  э _ ԓ ы г э _ ным _ ы н ӄ э н _ 
ԓьоо оравэтԓьан ынӄэн ԓьунэӈу	 ԓ ь о _ о _ о р а в э т ԓ ь а _ н _ ы н ӄ э н _ ԓ ь у _  н э _  ӈ у _ 
гэрэсӄивысӄычетԓин ченэтрачыкогты ынӄо нычимгъуӄин ӈэвысӄэт ынръа ӈан мэӈӄокэн оравэтԓьаӄай	 г э _  р э _  с ӄ и в ы _  с ӄ ы _ чет _ ԓин _ ч е н э _ т _  р а _  ч ы к о _ гты _ ы н ӄ о _ н ы _  ч и м г ъ у _ ӄин _ ӈ э в ы с ӄ э т _ ы н р ъ а _ ӈ а н _ м э ӈ _  ӄ о _  к э н _ о р а в э т ԓ ь а _  ӄ а й _ 
наӄам ԓыгэӄыԓпэ	 н а ӄ а м _ ԓ ы г _  э ӄ ы ԓ п э _ 
рэсӄиквъи ынкэгйит	 р э с _ ӄ _ ик _ въ _ и _ ы н к э г _ йит _ 
ԓыгэн пыкитчыӄиквъи ивыптэгнык ынӄо пыкиргъи	 ԓ ы г э н _ п ы к и т ч ы ӄ и к _ въ _ и _ и в ы п _  т э г н ы _ к _ ы н ӄ о _ п ы к и р _ гъ _ и _ 
ынкы ӄытԓыги ынӄэн кэрэкрэмкын аны	 ы н _ кы _ ӄ ы т ԓ ы г и _ ы н ӄ э н _ к э р _  э к р э _  м к ы _ н _ а н ы _ 
намӈыԓёйвын ынӄэн ӈэвысӄэт	 н а _  м ӈ ы ԓ ё _  й в ы _  н _ ы н ӄ э н _ ӈ э в ы с ӄ э т _ 
гамӈыԓтэтԓен ӈэвысӄэт	 г а _  м ӈ ы ԓ т э т _ ԓен _ ӈ э в ы с ӄ э т _ 
таӈымыԓьо тывъёонэн	 т а ӈ _  ы м ы ԓ ь о _ т ы _  в ъ ё о _  н э _  н _ 
ынин нымытвагыргытымы ынӄэн	 ы н _  и н _ н ы _  м ы т в а _  г ы р г ы т ы _  м ы _ ы н ӄ э н _ 
ӈан чит ярамкиӈык рээн нымытвагыргын	 ӈ а н _ ч и т _ я р а _  м к и ӈ ы _  к _ р э э н _ н ы _  м ы т в а _  г ы р г ы _ н _ 
ынкъам ымы	 ы н к ъ а м _ ы м ы _ 
йъэԓгытомгыт тывнэнат ытръэч ӄоон	 й ъ э _ ԓгытомгы _  т _ т ы в н э _ на _ т _ ы т р ъ э ч _ ӄ о о н _ 
миӈкы варкыт ынкъам	 м и ӈ _ кы _ в а р к ы _ т _ ы н к ъ а м _ 
ымы йъэԓгытомгыт тывнэнат ытръэч ӄоон миӈкы	 ы м ы _ й ъ э _  ԓ г ы т о м г ы _  т _ т ы в н э _ на _ т _ ы т р ъ э ч _ ӄ о о н _ м и ӈ _ кы _ 
варкыт нивӄинэт кэрэкыт энмэч морыкайпы ӄоԓ нитӄинэт	 в а р к ы _ т _ н _ ив _ ӄинэ _ т _ к э р э _  к ы т _ э н м э ч _ м о р ы _  к а _  й п ы _ ӄ о ԓ _ н _ ит _  ӄ и н э _ т _ 
ныгаԓяӄэнат ынӄо нанатвыгъан ӈэвысӄэт	 ны _  г а ԓ я _ ӄэна _ т _ ы н ӄ о _ н _  а н а _ твы _  г ъ а _ н _ ӈ э в ы с ӄ э т _ 
ӄуԓиныкитэ пыкиргъи	 ӄ у ԓ и _  н ы _  к и т _ э _ п ы к и р _ гъ _ и _ 
гэкэӈвыргыргын нэмэ кэрэкык ӄытԓыгиым	 г э к э ӈ _ выргыргы _ н _ н э м э _ к э р э _  к ы _  к _ ӄ ы т ԓ ы г и _  ы м _ 
ӄунԓеԓюн рэмкын ԓюур	 ӄ у н _  ԓ е ԓ ю н _ р э м к ы _ н _ ԓ ю у р _ 
вай ӄунԓеԓю ӈэнри ӄытгъи пынԓёнэнат	 в а й _ ӄ у н _  ԓ е ԓ ю _ ӈ э н _ ри _ ӄ ы т _ гъ _ и _ п ы н ԓ ё н _ эна _ т _ 
вынэ вай тургин чакыгэт ӈутку	 в ы н э _ в а й _ т у р г _ ин _ ч а к ы г э т _ ӈ у т к у _ 
ако эԓымӈэ эмъим	 а к о _ эԓым _ ӈэ _ э м _  ъ и м _ 
рай этки	 р а й _ э т _  к _ и _ 
вынэ мытрэԓьуӈыркын	 в ы н э _ м ы т _  р э _ ԓьу _ ӈы _  р к ы н _ 
ынӄо нотасӄычыкогты ӄытгъэт ынӄэнат ымыԓьо иийэ мэй ынӈатаԓым нымэԓьэв ӈэнку	 ы н ӄ о _ н о т а _  с ӄ ы _ чыко _  г т ы _ ӄ ы т _  г ъ э _ т _ ы н ӄ э н а _ т _ ы м ы ԓ ь о _ и и й э _ м э й _ ы н ӈ а т _ аԓым _ н ы _ мэԓьэв _ ӈ э н _  к у _ 
нынымытваӄэн наӄам	 ны _  н ы _  м ы т в а _  ӄ э н _ н а ӄ а м _ 
ԓыгонмычыко ымы	 ԓ ы г о _ нмы _  ч ы к о _ ы м ы _ 
ӄун ырык	 ӄ у н _ ы р ы _  к _ 
ротванвык эвыча наӄам ӈэнку ныԓгэӄэргатӄэн ээкэтэ	 р о т в а _ нвы _ к _ э в ы ч _ а _ н а ӄ а м _ ӈ э н _ ку _ н ы _  ԓ г э _  ӄ э р г _ ат _ ӄэн _ э э к э т _  э _ 
энмэч гъывэӄучитэ ӈэнку нынымытваӄэнат ныԓгиныгтиӈӄин ынин ывэӄуч ыӈко иквъи ӄунԓеԓю ынӄы ӄытваркын нымэԓьэв ынӄэн миӈкы эӄэԓьэ ныԓӄырирӄин чакыгэт	 э н м э ч _ г ъ _  ы в э ӄ у _  ч и т _  э _ ӈ э н _ ку _ н ы _  н ы _ мытва _  ӄ э н а _ т _ н ы _  ԓ г и _ ны _  г т и ӈ _  ӄ и н _ ы н _  и н _ ы в э ӄ у ч _ ы ӈ к о _ и к _ въ _ и _ ӄ у н _  ԓ е ԓ ю _ ы н ӄ ы _ ӄ ы _  т в а _  р к ы н _ н ы _  м э ԓ ь э в _ ы н ӄ э н _ м и ӈ _ кы _ э _  ӄ э ԓ _ ь _ э _ н ы _  ԓ ӄ ы р и р _  ӄ и н _ ч а к ы г э т _ 
ынкъам ынӄэната ганатчыӈатԓен	 ы н к ъ а м _ ы н ӄ э н а _ та _ г а _  н а _  т ч ы ӈ _ ат _ ԓен _ 
кэрэкитэ ынкъым гаԓгэкоргавԓен чакыгэт рыпэт ӄун ынӄэн чакэно нинъэйӈэвӄин ӄунԓеԓюнэ	 к э р э _  к и т _ э _ ы н _  к _  ъ ы м _ г а _  ԓ г э _  к о р г а в _  ԓ е н _ ч а к ы г э т _ р ы п э т _ ӄ у н _ ы н ӄ э н _ ч а к э н о _ н _  и н _  ъ э й ӈ э в _  ӄ и н _ ӄ у н _  ԓ е ԓ ю _  н э _ 
амкоргава аԓымы ӄырымэн чакыгэт ытръэч ӈавйъеԓгытомгын	 а м к о _ ргав _ а _ а ԓ ы м ы _ ӄ ы р ы м _ эн _ ч а к ы г э т _ ы т р ъ э ч _ ӈ а в _  й ъ _  е ԓ г ы т о м г ы _  н _ 
ынӄо гэквэтԓин ӄунԓеԓин рэмкын гамаравыԓьатԓен гэмгэԓымынкы	 ы н ӄ о _ г _ эквэт _ ԓин _ ӄ у н _  ԓ е _  ԓ и н _ р э м к ы _ н _ г а _  м а р а в ы _  ԓ ь а т _ ԓен _ г э _  м г _  э ԓ ы м _  ы н _  к ы _ 
ӄунԓеԓю миӈкыри ӄун ныԓӄыритъюуӄин ӄунԓеԓюнэ гэмгээӄэԓьэ ынкъам ынӄэната гамаравыԓьатԓен гамгааӄаԓьэты	 ӄ у н _  ԓ е ԓ ю _ м и ӈ _ кы _ ри _ ӄ у н _ н ы _  ԓ ӄ ы р и т ъ ю у _  ӄ и н _ ӄ у н _  ԓ е ԓ ю _  н э _ г э _  м г э э ӄ э ԓ _  ь _ э _ ы н к ъ а м _ ы н ӄ э н а _ та _ г а _  м а р а в ы _  ԓ ь а т _  ԓ е н _ г а _  м г а а ӄ а _  ԓ ь _ эты _ 
ӄынвэр энмэч гэԓгинымкэвԓин ынин ӈэԓвыԓ ӄунԓеԓюн	 ӄ ы н в э р _ э н м э ч _ г э _ ԓги _  н ы _  м к э в _  ԓ и н _ ы н _  и н _ ӈ э ԓ в ы ԓ _ ӄ у н _  ԓ е ԓ ю н _ 
аԓымы чит ӄунԓеԓю нотайпы	 а ԓ ы м ы _ ч и т _ ӄ у н _  ԓ е ԓ ю _ н о т а _  й п ы _ 
ԓейвэ итыԓьын ԓыгэн ӄун	 ԓ е й в э _ и т ы _  ԓ ь ы _  н _ ԓ ы г э н _ ӄ у н _ 
ӈъочьыӄай чит	 ӈ ъ о _ чьы _  ӄ а й _ ч и т _ 
эквырга нутэк таӈамнымытвата гаԓгэмчытвэԓен чама гэӈэӈытвиԓин чинит	 э к _ вырга _ н у т э _  к _ т а ӈ _  а м н ы _  м ы т в а _  т а _ г а _  ԓ г э _  м ч ы _ твэ _ ԓен _ ч а м а _ г э _  ӈ э ӈ ы _  т в и _ ԓин _ ч и н и т _ 
ыԓеӄинэт ӈанӄэн нэмэ пытԓяӄ нъэӄэԓьыгынтэвӄинэт ԓюур	 ы ԓ е _  ӄ и н э _ т _ ӈ а н _  ӄ э н _ н э м э _ п ы т ԓ я _ ӄ _ н _  ъ э ӄ _  э _  ԓ ь ы _  г ы н т э в _  ӄ и н э _ т _ ԓ ю у р _ 
ынкы тыԓянвык	 ы н _ кы _ т ы ԓ я _  н в ы _ к _ 
нэӈыръыԓьун ӄоԓ	 н э ӈ ы р ъ ы _  ԓ ь у _  н _ ӄ о ԓ _ 
оравэтԓьан ӄытԓыги	 о р а в э т ԓ ь а _ н _ ӄ ы т ԓ ы г и _ 
нэмыӄэй ԓыгиейвэԓӄэй нэпиригъэнгаӄэтывъэӈӈоԓен эвын нанрагтатын ярак пыкирык наномаатын ынӄэн ӄытԓыги энмэн	 н э м ы ӄ э й _ ԓ ы г _  и е й в _  э ԓ _  ӄ э й _ н э _  п и р и _  г ъ э н г а _  ӄ э т ы _  в ъ э _  ӈ ӈ о _  ԓ е н _ э в ы н _ н а _  н _  р а _ гт _  а т ы _ н _ я р а _  к _ п ы к и р ы _ к _ н а _  н _  о м а а т ы _  н _ ы н ӄ э н _ ӄ ы т ԓ ы г и _ э н м э н _ 
уӄӄэмӄэй ӄытԓыги нэмыӄэй ԓыгиейвэԓӄэй нэпиригъэнгаӄэтывъэӈӈоԓен эвын нанрагтатын ярак пыкирык наномаатын ынӄэн ӄытԓыги	 у ӄ ӄ э м _ ӄэй _ ӄ ы т ԓ ы г и _ н э м ы ӄ э й _ ԓ ы г _  и е й в _  э ԓ _  ӄ э й _ н э _  п и р и _  г ъ э н г а _  ӄ э т ы _  в ъ э _  ӈ ӈ о _  ԓ е н _ э в ы н _ н а _  н _  р а _ гт _  а т ы _ н _ я р а _  к _ п ы к и р ы _ к _ н а _  н _  о м а а т ы _  н _ ы н ӄ э н _ ӄ ы т ԓ ы г и _ 
энмэн уӄӄэмӄэй ԓыгэн	 э н м э н _ у ӄ ӄ э м _ ӄэй _ ԓ ы г э н _ 
ӄун ӄунԓэԓюнэ	 ӄ у н _ ӄ у н _  ԓ э ԓ ю _  н э _ 
нутэк тэӈэмԓьуткутэ гэнымкэвԓин ынин	 н у т э _  к _ т э ӈ _  э м _  ԓ ь у т к у _  т _ э _ г э _  н ы _  м к э в _  ԓ и н _ ы н _  и н _ 
итрэтӄэй юур	 и т р э т _ ӄэй _ ю у р _ 
вай ӄуԓивуԓӄытвик нэмэ	 в а й _ ӄ у ԓ _  и в у _ ԓӄы _ тви _  к _ н э м э _ 
гакаӈыԓьымкиӈын ныԓячаӄэн	 г а к а ӈ ы _  ԓ ь ы _  м к и ӈ ы _  н _ н ы _  ԓ я ч а _  ӄ э н _ 
ынӈатаԓым ныԓгинымкыӄин	 ы н ӈ а т _ аԓым _ ны _  ԓ г и _  н ы _ мкы _ ӄин _ 
ӄытԓыги эӄэԓьын нэмэ ԓыгэн	 ӄ ы т ԓ ы г и _ э ӄ э _  ԓ ь ы _ н _ н э м э _ ԓ ы г э н _ 
кыткаракэгъет пыкитчыӄиквъэт ынкы	 к ы т к а р а _  к э г _  ъ е _  т _ п ы к и т ч ы ӄ и к _ въэ _ т _ ы н _ кы _ 
пыкиргъэт ынкъам нымӈыԓёӄэнат	 п ы к и р _  г ъ э _ т _ ы н к ъ а м _ н ы _  м ӈ ы ԓ ё _  ӄ э н а _ т _ 
ванэван ӄыԓьугыткы ӄытвыгыткы гэмо моргынан ымыԓьэты	 в а н э в а н _ ӄ ы _  ԓ ь у _ гы _  т к ы _ ӄ ы т в ы _  г ы т к ы _ г э _ мо _ м о р г ы _ нан _ ы м ы ԓ ь _ эты _ 
ӄунԓеԓюн рэмкын вэнԓыги танԓёӈытва нэнтынэт ӄунԓеԓюн рэмкын аԓымы ымы ынкы нытваӄэн ыргин чакыгэт ӈавйъеԓгытомгын эквэтгъи	 ӄ у н _  ԓ е ԓ ю н _ р э м к ы _ н _ в э н ԓ ы г и _ т а н ԓ ё _  ӈ ы _  т в а _ н э _  н т ы _  н э _ т _ ӄ у н _ ԓеԓюн _ р э м к ы _  н _ а ԓ ы м ы _ ы м ы _ ы н _ кы _ н ы _ тва _ ӄэн _ ы р г и н _ ч а к ы г э т _ ӈ а в _  й ъ _  е ԓ г ы т о м г ы _  н _ э к в э т _ гъ _ и _ 
ынӄэн этратчыӈын	 ы н ӄ э н _ э т р а _ тчы _  ӈ ы _ н _ 
ако ынраӄ ынӄэн	 а к о _ ы н р а _ ӄ _ ы н ӄ э н _ 
ръэт нэркыԓейвын ӄунԓеԓюргин юур вай	 р ъ э _ т _ н э _  р к ы _  ԓ е й в ы _ н _ ӄ у н _  ԓ е ԓ ю р г _  и н _ ю у р _ в а й _ 
вытратычгатгъэ этратчыӈын ӄунԓеԓю нычимгъуӄин ынӄо нивӄинэт ӄунԓеԓюн тумгыт	 в ы т р а _ ты _  ч г _ ат _ гъэ _ э т р а _  т ч ы _  ӈ ы _ н _ ӄ у н _ ԓеԓю _ н ы _  ч и м г ъ у _ ӄин _ ы н ӄ о _ н _ ив _  ӄ и н э _ т _ ӄ у н _  ԓ е ԓ ю н _ т у м г ы _ т _ 
ӄунԓеԓюнэ ивнинэт эвнэгынтэвкэ мачынан ынйъомык аны нычимгъуӄин	 ӄ у н _  ԓ е ԓ ю _  н э _ и в _ ни _  н э _ т _ э в н э _  г ы н т э в _  к _ э _ м а ч ы _ нан _ ы н й ъ о _  м ы к _ а н ы _ н ы _  ч и м г ъ у _ ӄин _ 
ӄунԓеԓю нивӄин	 ӄ у н _  ԓ е ԓ ю _ н _ ив _ ӄин _ 
ымӈан этъопэԓ миӈкыри мынынтынэт	 ы м ӈ а н _ э т ъ о _ пэԓ _ м и ӈ _ кы _ ри _ м ы н ы _ нты _  н э _ т _ 
наӄам ӄунԓеԓюн тумгыт	 н а ӄ а м _ ӄ у н _  ԓ е ԓ ю н _ т у м г ы _  т _ 
ԓыгитъэркинэт нынныт ыргинэт 	 ԓ ы г и т ъ э р _  к и н э _ т _ н ы н н ы _  т _ ы р г и _ нэ _ т _ _ 
пэтывтычгын ирэпиӄытъым вэтгавкытувъе чеграйӈо	 п э т ы _  в т ы ч г ы _  н _ и р э _  п и ӄ ы _ т _  ъ ы м _ в э т г а в _  к ы т у _  в ъ _  е _ ч е г р а _  й ӈ о _ 
ыттъыӄопай риӄуӄӄэй ынкъам уӄӄэмэӄэй ӈан	 ы т т ъ ы ӄ о _  п а й _ р и ӄ у ӄ _  ӄ э й _ ы н к ъ а м _ у ӄ ӄ э м э _  ӄ э й _ ӈ а н _ 
нутэк ԓьоо ынкъам ӄутти нэмыӄэй	 н у т э _  к _ ԓ ь о _ о _ ы н к ъ а м _ ӄ у т _ ти _ н э м ы ӄ э й _ 
нутэк ԓьооӄагтэ ӄынвэр ивнинэт ӄунԓеԓюнэ ынкъам	 н у т э _  к _ ԓ ь о _ о _  ӄ а г _ тэ _ ӄ ы н в э р _ и в _ ни _  н э _ т _ ӄ у н _ ԓеԓю _  н э _ ы н к ъ а м _ 
ынӈин ӄаанэтԓета	 ы н ӈ и н _ ӄ а а н э т ԓ е т _  а _ 
мынԓеркын ытри моогьат ӄаанэтԓетыԓьатык	 м ы н _  ԓ е _ ркын _ ы т р и _ м о о _  г ь а _  т _ ӄ а а н э т ԓ е т ы _  ԓ ь а _  т ы к _ 
гамгорвэты аны ӈоты	 г а _  м г о р в _  э т ы _ а н ы _ ӈ о т ы _ 
ԓыгэймэквъэт эӄэԓьыт ӄунԓеԓю гиръытвыԓин	 ԓ ы г _  э й м э к _  в ъ э _ т _ э _  ӄ э ԓ ь ы _ т _ ӄ у н _  ԓ е ԓ ю _ г и _  р ъ ы т в ы _  ԓ и н _ 
тэӈиръыкэ нъэԓгъи амыным	 т э ӈ _  и р ъ ы _  к _  э _ н _  ъ э ԓ _ гъ _ и _ а м _  ы н ы м _ 
ныԓгитэнтымгэтӄин ӈаргынэн таӈайъыткынка ымы ӄунԓеԓю иръытвинэӈу гаӄъоԓяԓен кытгыргоԓягты ӄынур ины ӄъоԓяпԓыткой	 ны _  ԓ г и _  т э н _ тымгэт _ ӄин _ ӈ а р г ы _  н э н _ т а ӈ а _  й ъ ы _ ткын _ к _ а _ ы м ы _ ӄ у н _  ԓ е ԓ ю _ и р ъ ы _  т в и н э _  ӈ у _ г а _  ӄ ъ о ԓ я _ ԓен _ к ы т г ы р г о ԓ я _ гты _ ӄ ы н у р _ и н ы _ ӄ ъ о ԓ я _  п ԓ ы т к о _  й _ 
 нэръэпыӄэн эръэпыма эвыр	 _ н э _  р ъ _  э п ы _  ӄ э н _ э р ъ _  э п ы м _  а _ э в ы р _ 
ныйъэтӄин ӈаргынэн ԓыгэӄыԓпэ рэченма ныпиӈэръуӄин къаԓейпыма 	 ны _  й ъ э т _ ӄин _ ӈ а р г ы _  н э н _ ԓ ы г _  э ӄ ы ԓ п э _ р э ч е н _  м а _ н ы _  п и ӈ э _ ръу _ ӄин _ к ъ а ԓ е _  й п ы м _  а _ _ 
нывъятԓьоӄэн ԓейпыма ныпыԓмыръоӄэн эвыр	 ны _  в ъ я т _  ԓ ь о _ ӄэн _ ԓ е й п ы м _  а _ н ы _  п ы ԓ м ы _ ръо _  ӄ э н _ э в ы р _ 
тантэнмавыпԓыткой орвэты ӄытгъи орвык вакъой аны тэнԓыԓечурмэтэ гапыԓмыръочгатԓен вачаӄ вэнԓыги	 т а н т э _  н м а в ы _  п ԓ ы т к о _  й _ о р в _ эты _ ӄ ы т _ гъ _ и _ о р в ы _  к _ в а к ъ о _  й _ а н ы _ т э н ԓ ы ԓ е _  ч у р м э _  т э _ г а _  п ы ԓ м ы _  р ъ о ч г _ ат _ ԓен _ в а ч а ӄ _ в э н ԓ ы г и _ 
ынӈин ныԓеӄинэт ынкъам ныянотӄэн тумгэӄэй ирэпиӄытъым аны ныԓеӄинэт атав ынӈин	 ы н ӈ и н _ н ы _  ԓ е _  ӄ и н э _ т _ ы н к ъ а м _ н ы _  я н о т _  ӄ э н _ т у м г э _ ӄэй _ и р э _  п и ӄ ы _ т _  ъ ы м _ а н ы _ н ы _  ԓ е _  ӄ и н э _ т _ а т а в _ ы н ӈ и н _ 
вуԓӄытвий ӄынвэр нывиԓгъэт ынкы ӄунԓеԓюн мараврат ынкы	 в у ԓ ӄ ы _ тви _  й _ ӄ ы н в э р _ н ы _  в и ԓ г _ ъэ _ т _ ы н _ кы _ ӄ у н _  ԓ е ԓ ю н _ м а р а в р а _ т _ ы н _ кы _ 
нэмэ нымэԓеттыԓеӄин ӈаргынэн ӄунԓеԓюнэ ивнинэт	 н э м э _ н ы _  м э ԓ е т _  т ы ԓ е _ ӄин _ ӈ а р г ы _  н э н _ ӄ у н _ ԓеԓю _  н э _ и в _ ни _  н э _ т _ 
тумгыт нэмэ ӄунԓеԓюнэ ивнинэт	 т у м г ы _ т _ н э м э _ ӄ у н _  ԓ е ԓ ю _  н э _ и в _ ни _  н э _ т _ 
пэԓӄынтэтгъэт ораяаԓегты ӈоонӄо тыԓек ивнинэт мэрынрэӄэй тумгыт	 п э ԓ ӄ ы н т _ эт _  г ъ э _ т _ о р а _  я а ԓ е _ гты _ ӈ о о н _  ӄ о _ т ы ԓ е _  к _ и в _ ни _  н э _ т _ м э р ы н р э _  ӄ э й _ т у м г ы _  т _ 
мынчамэттанат 	 м ы н _  ч а м э т т а _  н а _ т _ _ 
ӈаан ныйыԓӄатчаӄэнат тумгиирыкым эвыр ночӄэн ынӄо ӈааанӄо	 ӈ а а н _ н ы _  й ы ԓ ӄ _  а т ч а _ ӄэна _ т _ т у м г _  и и р ы _  к ы м _ э в ы р _ н о ч _  ӄ э н _ ы н ӄ о _ ӈ а а а _  н _  ӄ о _ 
тыԓек ивнинэт нэмэ	 т ы ԓ е _  к _ и в _ ни _  н э _ т _ н э м э _ 
тумгыт эченур ирвыт таӈымыԓьо	 т у м г ы _ т _ э ч е н _ ур _ и р в ы _ т _ т а ӈ _  ы м ы ԓ ь о _ 
мынынԓейвынэт юрэӄ ӈаан ыръыйыԓӄэтыркыт эвытԓым виин амыргынан ытръэч	 м ы н ы _ н _  ԓ е й в ы _  н э _ т _ ю р э ӄ _ ӈ а а н _ ы р ъ ы _  й ы ԓ ӄ _ эты _  р к ы _ т _ э в ы т ԓ ы м _ в и и н _ а м ы р г ы _ нан _ ы т р ъ э ч _ 
пойгыт мынынрынэт ик тумгыӄэгти ӄунԓеԓюн айыԓгыкыԓьэнат	 п о _  й г ы т _ м ы _  н ы н р ы _  н э _ т _ и _ к _ т у м г ы _  ӄ э г _ ти _ ӄ у н _  ԓ е ԓ ю н _ а й ы ԓ _  г ы _  к ы _ ԓь _  э н а _ т _ 
нымэԓьэв гатэнмавръоԓенат начамэттанат ынӄэн йыԓӄыԓьыгинив энмэч пыкиргъэт ырык	 ны _  м э ԓ ь э в _ г а _  т э _  н м _ ав _  р ъ о _ ԓена _ т _ н а ч а м э т т а _  н а _ т _ ы н ӄ э н _ й ы ԓ ӄ ы _ ԓьы _  г и н _ ив _ э н м э ч _ п ы к и р _ гъэ _ т _ ы р ы _ к _ 
 эвын ныйыԓӄатчаӄэнат нэмэ ивнинэт	 _ э в ы н _ н ы _  й ы ԓ ӄ _  а т ч а _ ӄэна _ т _ н э м э _ и в _ ни _  н э _ т _ 
ӄунԓеԓюнэ эчги	 ӄ у н _  ԓ е ԓ ю _  н э _ э ч г и _ 
мытрэпԓыткуӈынэт майынԓяк ирвыт ынраӄ йыԓӄыԓьыт	 м ы т _  р э _  п ԓ ы т к у _  ӈ ы _  н э _ т _ м а й ы н ԓ я _  к _ и р в ы _ т _ ы н р а _ ӄ _ й ы ԓ ӄ ы _  ԓ ь ы _  т _ 
мынынмыткойвынат ԓыгэн	 м ы н ы _  н м ы _  т к о _  й в ы _  н а _  т _ ԓ ы г э н _ 
ынкы орвык ыпэ майынԓяк	 ы н _ кы _ о р в ы _  к _ ы п э _ м а й ы н ԓ я _  к _ 
ирвыт ынраӄ йыԓӄыԓьыт мынынмыткойвынат	 и р в ы _ т _ ы н р а _ ӄ _ й ы ԓ ӄ ы _ ԓьы _  т _ м ы н ы _  н м ы _  т к о _  й в ы _  н а _ т _ 
ԓыгэн ынкы	 ԓ ы г э н _ ы н _ кы _ 
орвык ыпэ намгонат ирвыт	 о р в ы _  к _ ы п э _ н а м г о _ на _ т _ и р в ы _ т _ 
тыгинрыԓьэтык орвэпы ԓыгэн	 т ы _  г и н р ы _  ԓ ь _  э т ы _ к _ о р в _  э п ы _ ԓ ы г э н _ 
ныԓгэӄэйыԓӄатчаӄэнат аӄаԓьымкычгын нэпԓыткунэт майынԓяк ирвыт ынӄо	 ны _  ԓ г э _  ӄ э й _  ы ԓ ӄ _  а т ч а _  ӄ э н а _ т _ а _  ӄ а ԓ ь ы _  м к ы ч г ы _ н _ н э _  п ԓ ы т к у _  н э _ т _ м а й ы н ԓ я _  к _ и р в ы _ т _ ы н ӄ о _ 
ивнинэт нэмэ	 и в _ ни _  н э _ т _ н э м э _ 
ӄунԓеԓюнэ ԓыгэн ынкы нытынпычерӄэнат	 ӄ у н _  ԓ е ԓ ю _  н э _ ԓ ы г э н _ ы н _ кы _ н ы _  т ы н п ы _  ч е р _  ӄ э н а _ т _ 
эӄэԓьыт аны нырэԓиԓӄутръуӄинэт эӄэԓьыгинив наӄам эвыр чыкэевыԓьын орвэпы нэнарэрыԓьатӄэнат ченэтэрвэты	 э _  ӄ э ԓ ь ы _ т _ а н ы _ н ы _  р э ԓ и ԓ _  ӄ у т _  р ъ у _  ӄ и н э _ т _ э _ ӄэԓьы _  г и н _ ив _ н а ӄ а м _ э в ы р _ ч ы к э е в ы _  ԓ ь ы _ н _ о р в _ эпы _ н _  э н а _  р э р ы _ ԓьат _  ӄ э н а _ т _ ч е н э _  т э р в _  э т ы _ 
наӄам ԓьук ныԓвавӄэнат ирвыт	 н а ӄ а м _ ԓ ь у _  к _ н ы _  ԓ в а в _  ӄ э н а _ т _ и р в ы _ т _ 
аны ынкы наԓгэнмыткойвынат	 а н ы _ ы н _ кы _ н а _  ԓ г э _  н м ы _ тко _  й в ы _  н а _  т _ 
эӄэԓьыт ӄунԓеԓюнэ мараврата гынтэвыԓьыт тиӈурэ нычеӈкайвыӄэнат нэмэ ынкы тэӈыткунинэт	 э _  ӄ э ԓ ь ы _ т _ ӄ у н _  ԓ е ԓ ю _ нэ _ м а р а в р а _  т а _ г ы н т э в ы _ ԓьы _  т _ т _  и ӈ у р э _ н ы _  ч е ӈ _  к а й в ы _ ӄэна _ т _ н э м э _ ы н _ кы _ т э ӈ ы _  т к у _  н и _  н э _ т _ 
эӄэԓьыт ӄунԓеԓюнэ мараврата аԓымы тъэркинэӄэй ӄунԓеԓюн	 э _  ӄ э ԓ ь ы _ т _ ӄ у н _  ԓ е ԓ ю _ нэ _ м а р а в р а _  т а _ а ԓ ы м ы _ т ъ э р _  к и н э _  ӄ э й _ ӄ у н _  ԓ е ԓ ю н _ 
мараврат ӄоныръым гагыттавъяԓенат	 м а р а в р а _  т _ ӄ о н ы _ р _ ъым _ г а _  г ы т т а в ъ я _  ԓ е н а _ т _ 
ӄунԓеԓюнэ таӈымыԓьо выятӄаат ынкы ӈэԓвыԓьу нагтатын	 ӄ у н _  ԓ е ԓ ю _  н э _ т а ӈ _ ымыԓьо _ в ы я т _  ӄ а а т _ ы н _ кы _ ӈ э ԓ в ы _  ԓ ь _  у _ н _  а г т а т ы _ н _ 
ярагты ынкы ӄутти анмыка рытъёттэ ӄаагтатыԓьо	 я р а _  г т ы _ ы н _ кы _ ӄ у т _ ти _ а н _ мык _  а _ р ы т ъ ё т _ тэ _ ӄ а а _  г т а т ы _  ԓ ь _  о _ 
нэԓгынэт ӈан оравэтԓьат ынвэр	 н _  э ԓ г ы _  н э _ т _ ӈ а н _ о р а в э т ԓ ь а _ т _ ы н в э р _ 
ӄунԓеԓюргин ӈаԓвыԓьиӈын гэԓгимкэтԓин миӈкыри ӄун	 ӄ у н _  ԓ е ԓ ю р г _  и н _ ӈ а ԓ в ы _  ԓ ь _ иӈы _  н _ г э _  ԓ г и _  м к э т _ ԓин _ м и ӈ _ кы _ ри _ ӄ у н _ 
танԓымынӄо эмиткэйвык наӄам гамгаԓымынӄо	 т а н ԓ ы м _ ынӄо _ э _  м и т _  к э й в ы _  к _ н а ӄ а м _ г а _  м г а ԓ ы м _  ы н ӄ о _ 
ныԓӄыритъюуӄин эӄэԓьэ ӄунԓеԓю ӄынвэр уйӈэ нъэԓгъи эӄэԓьыкэ аны	 ны _  ԓ ӄ ы р и т ъ ю у _  ӄ и н _ э _  ӄ э ԓ _ ь _ э _ ӄ у н _ ԓеԓю _ ӄ ы н в э р _ у й ӈ э _ н _  ъ э ԓ _ гъ _ и _ э _  ӄ э ԓ ь ы _  к _  э _ а н ы _ 
ӄунԓеԓю ганӈэнайпыԓен нивӄин ԓюур	 ӄ у н _  ԓ е ԓ ю _ г а _  н ӈ э н а _ йпы _ ԓен _ н _ ив _  ӄ и н _ ԓ ю у р _ 
ӄоԓ ӄуԓиԓьэтгъи ӄԓявыԓ ынӄэн	 ӄ о ԓ _ ӄ у ԓ и _ ԓьэт _ гъ _ и _ ӄ ԓ я в ы ԓ _ ы н ӄ э н _ 
мотԓынтона ынӄо иквъи ӄунԓеԓю ытръэч ԓыгимиӈкы	 м о т ԓ ы н т о _  н а _ ы н ӄ о _ и к _ въ _ и _ ӄ у н _  ԓ е ԓ ю _ ы т р ъ э ч _ ԓ ы г и м и ӈ _ кы _ 
варкын ивнин ӄунԓеԓюнэ уӄӄэмӄэй ынӄо уӄӄэмӄэйынэ ивнинэт	 в а _  р к ы н _ и в _ ни _ н _ ӄ у н _ ԓеԓю _  н э _ у ӄ ӄ э м _ ӄэй _ ы н ӄ о _ у ӄ ӄ э м _ ӄэй _  ы н _  э _ и в _ ни _  н э _ т _ 
ынкъам мыныюмӈимык нанмынат ынӄэнат рымӈэвъёно	 ы н к ъ а м _ м ы н ы _  ю м ӈ и _  м ы к _ н _  а н м ы _  н а _  т _ ы н ӄ э н а _ т _ р ы м ӈ э в _  ъ ё н _ о _ 
ынӄо нымӈиӄин уӄӄэмӄэй нутэк ԓьоо нивӄин уӄӄэмӄэй ынкы нэмэ	 ы н ӄ о _ н ы _  м ӈ и _ ӄин _ у ӄ ӄ э м _ ӄэй _ н у т э _  к _ ԓ ь о _ о _ н _  и в _ ӄин _ у ӄ ӄ э м _ ӄэй _ ы н _ кы _ н э м э _ 
мытрэмӈигъэ ынкъым вэчьым	 м ы т _  р э _  м ӈ и _  г ъ _  э _ ы н _  к _  ъ ы м _ в э ч _ ьым _ 
мытрэԓьуӈын мотԓынто ыныкит мытранмыӈын майӈывопӄы вэчьым ӄун мытрэԓьуӈын мотԓынто ынӄо	 м ы т _  р э _  ԓ ь у _  ӈ ы _ н _ м о т ԓ ы н т о _ ы н ы _ кит _ м ы т _  р а _ нмы _ ӈы _ н _ м а й ӈ ы _  в о п ӄ ы _ в э ч _ ьым _ ӄ у н _ м ы т _  р э _ ԓьу _  ӈ ы _ н _ м о т ԓ ы н т о _ ы н ӄ о _ 
пԓыткугъэт мыӈик аны	 п ԓ ы т к у _  г ъ э _ т _ м ы ӈ _  и к _ а н ы _ 
ӈан гэмгутыԓеԓинэт ԓыгэн	 ӈ а н _ г э _  м г у _  т ы ԓ е _  ԓ и н э _ т _ ԓ ы г э н _ 
ӄооӈ миӈкыри ръаянраӈаеты ымтыԓяӈэт ныръэтгэтаӄэн	 ӄ о о ӈ _ м и ӈ _ кы _ ри _ р ъ а я _  н _  р а _  ӈ а _  е т ы _ ы м _  т ы ԓ я _  ӈ э т _ н ы _  р ъ э т _  г э т а _  ӄ э н _ 
ирэпиӄытъым наӄам ытԓён эԓгаргаканъёԓьын ԓюур ирэпиӄытъым иквъи вэчьым ӄун ынӄэн уӄӄэмӄэй	 и р э _  п и ӄ ы _ т _  ъ ы м _ н а ӄ а м _ ы т ԓ ё н _ э ԓ г а _  р г а к а н ъ ё ԓ ь ы _  н _ ԓ ю у р _ и р э _  п и ӄ ы _ т _  ъ ы м _ и к _ въ _ и _ в э ч _ ьым _ ӄ у н _ ы н ӄ э н _ у ӄ ӄ э м _ ӄэй _ 
нивӄин вынэатав ԓыгэн ынкэгйит мынԓеркын 	 н _  и в _ ӄин _ в ы н э а т а в _ ԓ ы г э н _ ы н к э г _ йит _ м ы н _  ԓ е _ ркын _ _ 
эпԓеэн ръэӈэй ынӄэн аны	 э п ԓ е э н _ р ъ э _  ӈ э й _ ы н ӄ э н _ а н ы _ 
нымгутыԓеӄинэт атав	 н ы м г у т ы ԓ е _ ӄинэ _ т _ а т а в _ 
ԓыгэн ынкэгйит ԓюур	 ԓ ы г э н _ ы н к э г _ йит _ ԓ ю у р _ 
ӄэгԓынангэр вытрэтгъи янраӈагчыӈын	 ӄ э г ԓ ы _ нан _  г э р _ в ы т р э т _ гъ _ и _ я н р а _  ӈ а г ч ы _  ӈ ы _  н _ 
ынкэсӄыкым нывытрэтӄин ӄынур майӈыпырӄаквыԓгын 	 ы н к э _  с ӄ ы _  к ы м _ н ы _  в ы т р э т _ ӄин _ ӄ ы н у р _ м а й ӈ ы _  п ы р ӄ а к _  в ы _  ԓ г ы _ н _ _ 
ӄытԓыги майӈывопӄачгын ынкэгиӈкы рэвиквъэт ынӄэн майӈыянраӈайгэӈкы	 ӄ ы т ԓ ы г и _ м а й ӈ ы _  в о п ӄ а ч _  г ы _  н _ ы н к э г и ӈ _ кы _ р э в и к _ въэ _ т _ ы н ӄ э н _ м а й ӈ ы _  я н р а _  ӈ а й _  г э ӈ _ кы _ 
ынӄо эквэтгъэт ӈэнри ӈэйыттэтгъэт	 ы н ӄ о _ э к в э т _  г ъ э _ т _ ӈ э н _  р и _ ӈ э й ы т _  т э т _  г ъ э _ т _ 
ӈыроргарэ	 ӈ ы р о р г а _ рэ _ 
 ирэпиӄытъым уӄӄэмӄэй ынкъам ӄунԓеԓю	 _ и р э _  п и ӄ ы _ т _  ъ ы м _ у ӄ ӄ э м _  ӄ э й _ ы н к ъ а м _ ӄ у н _ ԓеԓю _ 
нычамэттаӄэн вопӄайӈын ӄынвэр нэԓгинэймэвын ынкы	 ны _  ч а м э т т а _  ӄ э н _ в о п ӄ а й ӈ ы _  н _ ӄ ы н в э р _ н э _  ԓ г и _  н _  э й м э _ вы _ н _ ы н _ кы _ 
ытԓёнайӈын нытԓытвачгатӄэн ӄынур пырӄаквыԓгычгын ԓюур нэтиӈутчиргъэн ӈыронԓяӈо	 ы т ԓ ё н а _ йӈы _ н _ н ы _  т ԓ ы т в а _  ч г _ ат _ ӄэн _ ӄ ы н у р _ п ы р ӄ а к _  в ы _  ԓ г ы ч г ы _ н _ ԓ ю у р _ н э _  т _  и ӈ у т _  ч и р _  г ъ э _ н _ ӈ ы р о н ԓ я _  ӈ о _ 
 ынкы нэтэӈкыргун вопӄайӈын ынӄо	 _ ы н _ кы _ н э _  т э ӈ _  к ы р г у _  н _ в о п ӄ а й ӈ ы _  н _ ы н ӄ о _ 
нэнкэвчитчевын ӈайӄаԓетԓы нэныпкирэтгъэн ярак нэнвэнӈын	 н э _  н к э в _  ч и т ч е в ы _  н _ ӈ а й _  ӄ а ԓ е _ тԓы _ н э _  н ы _ пкир _ эт _ гъэ _ н _ я р а _ к _ н э _ н _  в э н _  ӈ ы _ н _ 
ӈэвысӄэтэ ынӄо ивнинэт уӄӄэмӄэйынэ гэмӈиԓин уӄӄэмӄэй энмэн	 ӈ э в ы с ӄ э т _  э _ ы н ӄ о _ и в _ ни _  н э _ т _ у ӄ ӄ э м _  ӄ э й _  ы н э _ г э _  м ӈ и _ ԓин _ у ӄ ӄ э м _ ӄэй _ э н м э н _ 
йъэԓыги ныӄуӈычгэтӄин нинивӄин ӄунԓеԓюнэ энмэч эӄыԓпэ ӄырэԓьуӈыркын мотԓынто ынӄо	 й ъ _ эԓыги _ н ы _  ӄ у ӈ ы _  ч г э т _ ӄин _ н _  и н _ ив _ ӄин _ ӄ у н _  ԓ е ԓ ю _  н э _ э н м э ч _ э ӄ ы ԓ п э _ ӄ ы р э _  ԓ ь у _  ӈ ы _  р к ы н _ м о т ԓ ы н т о _ ы н ӄ о _ 
уӄӄэмӄэй иквъи ынӄэн	 у ӄ ӄ э м _ ӄэй _ и к _ въ _ и _ ы н ӄ э н _ 
нымным мытрамӈыԓёйвыӈын ӄоԓ ынкэкин оравэтԓьан ытръэч ӄун нэмэԓым нотасӄычыковты ваԓьыраԓьыт чамъам мытрэԓьуӈынэт ынӄо пԓыткуй вэтгавкы уӄӄэмӄэй ӄунԓеԓю	 н ы м н ы м _ м ы т _  р а _  м ӈ ы ԓ ё _  й в ы _  ӈ ы _ н _ ӄ о ԓ _ ы н _  к э _ кин _ о р а в э т ԓ ь а _ н _ ы т р ъ э ч _ ӄ у н _ н э м э ԓ ы м _ н о т а _  с ӄ ы _  ч ы к о _  в т ы _ в а _ ԓьы _  р а _  ԓ ь ы _  т _ ч а м ъ а м _ м ы т _ рэ _ ԓьу _ ӈы _  н э _ т _ ы н ӄ о _ п ԓ ы т к у _  й _ в э т г а в _  к ы _ у ӄ ӄ э м _ ӄэй _ ӄ у н _  ԓ е ԓ ю _ 
гивԓин ынӄо ръэйвэтгъэт ынкъам мууԓӄытгъэт	 г _  и в _ ԓин _ ы н ӄ о _ р ъ э й в _  э т _  г ъ э _  т _ ы н к ъ а м _ м у у _  ԓ ӄ ы т _ гъэ _ т _ 
нэмэ гэмгутыԓеԓьэтԓинэт котчой ныянрагакаӈыԓьатӄэнат ӈыроргарэ ирэпиӄытъым	 н э м э _ г э _  м г у _  т ы ԓ е _  ԓ ь э т _  ԓ и н э _ т _ к о т ч о _  й _ н ы _  я н _ ра _  г а к а ӈ ы _  ԓ ь а т _  ӄ э н а _ т _ ӈ ы р о р г а _ рэ _ и р э _  п и ӄ ы _ т _  ъ ы м _ 
ӄунԓеԓю уӄӄэмӄэй ирэпиӄытъым	 ӄ у н _  ԓ е ԓ ю _ у ӄ ӄ э м _  ӄ э й _ и р э _  п и ӄ ы _ т _  ъ ы м _ 
нэмэ ныёпыԓӄэвыԓьатӄэн тэнԓымынкыри тыԓяма нэмэ ивнинэт тумгыт нивӄин уӄӄэмӄэй ныянотӄэн ирэпиӄытъым ԓюур	 н э м э _ н ы _  ё _  п ы ԓ ӄ э в ы _  ԓ ь а т _ ӄэн _ т э н ԓ ы м _ ын _ кы _ ри _ т ы ԓ я _ ма _ н э м э _ и в _ ни _  н э _ т _ т у м г ы _ т _ н _ ив _ ӄин _ у ӄ ӄ э м _ ӄэй _ н ы _  я н о т _  ӄ э н _ и р э _  п и ӄ ы _ т _  ъ ы м _ ԓ ю у р _ 
вай пыкиргъэт ӄэгԓынангэр	 в а й _ п ы к и р _  г ъ э _ т _ ӄ э г ԓ ы _ нан _  г э р _ 
ынкы нытваӄэн тытыԓ нотасӄычыкогты	 ы н _ кы _ н ы _ тва _ ӄэн _ т ы _  т ы ԓ _ н о т а _ сӄы _ чыко _  г т ы _ 
ӄынур имчьэчукин ивнинэт	 ӄ ы н у р _ и м ч ь _  э ч у _  к и н _ и в _ ни _  н э _ т _ 
ӄунԓеԓюнэ гапэрӄытваԓен ӄунԓеԓю наӄам	 ӄ у н _  ԓ е ԓ ю _  н э _ г а _  п э р ӄ ы _  т в а _  ԓ е н _ ӄ у н _  ԓ е ԓ ю _ н а ӄ а м _ 
эԓгарӄааԓьын ынин	 э ԓ г _  а р _  ӄ а а _  ԓ ь ы _  н _ ы н _  и н _ 
гакаӈӄор эмъаԓвэнӄор ныԓгининъыӄин	 г а к а _ ӈӄор _ э м _  ъ а ԓ в _  э н _  ӄ о р _ н ы _  ԓ г и _  н и _ нъы _ ӄин _ 
наӄам майӈыԓеӈгыргыԓьын	 н а ӄ а м _ м а й ӈ ы _  ԓ е ӈ _  г ы р г ы _  ԓ ь ы _ н _ 
ынин таӈымыԓьэты ниԓгыӄин	 ы н _  и н _ т а ӈ _  ы м ы ԓ ь _ эты _ н _  и ԓ г ы _ ӄин _ 
ӄунԓеԓюн увик миӈкыри ӄун эԓгувтычгыԓьын эԓгыӄонагԓьан	 ӄ у н _  ԓ е ԓ ю н _ у в и к _ м и ӈ _ кы _ ри _ ӄ у н _ э ԓ г у _  в т ы ч г ы _  ԓ ь ы _  н _ э ԓ г ы _  ӄ о н а г ԓ ь а _  н _ 
иԓгыԓиԓьын ԓыгэн ӄун ымыԓьэты ниԓгыӄин ынин орвоор	 и ԓ г ы ԓ и _  ԓ ь ы _  н _ ԓ ы г э н _ ӄ у н _ ы м ы ԓ ь _ эты _ н _  и ԓ г ы _ ӄин _ ы н _  и н _ о р в о о р _ 
эвыр ӄооԓгыт ԓюур аатчеӄӄай	 э в ы р _ ӄ о о _  ԓ г ы т _ ԓ ю у р _ а а _  т _  ч е ӄ _ ӄай _ 
ӈытогъэ янор эмԓевыт рынтоӈаннэн	 ӈ ы т о _ гъ _ э _ я н о р _ э м _  ԓ е в ы т _ р ы н т о _  ӈ а н _ нэ _ н _ 
тэнԓымынкыри нытԓепыткуԓьэтӄин ынӄо	 т э н ԓ ы м _ ын _ кы _ ри _ н ы _  т _  ԓ е п ы т к у _  ԓ ь э т _  ӄ и н _ ы н ӄ о _ 
ӄынвэр ымыԓьэты увик рынтоӈаннэн	 ӄ ы н в э р _ ы м ы ԓ ь _ эты _ у в и к _ р ы н т о _  ӈ а н _ нэ _  н _ 
ынӄо ӈытосӄычатгъэ таӈванэван ныԓьунин атчытваԓьын	 ы н ӄ о _ ӈ ы т о _  с ӄ ы ч _ ат _ гъэ _ т а ӈ _  в а н э в а н _ н ы _  ԓ ь у _ ни _ н _ а т ч ы _  т в а _ ԓьы _ н _ 
ӄунԓеԓю эчги	 ӄ у н _  ԓ е ԓ ю _ э ч г и _ 
ӈытосӄычатгъэ	 ӈ ы т о _  с ӄ ы ч _ ат _ гъэ _ 
аатчеӄӄай пэнрысӄычаннэн	 а а _  т _  ч е ӄ _ ӄай _ п э н р ы _  с ӄ ы _  ч а н _ нэ _  н _ 
ытԓён ӄунԓеԓюнэ аны	 ы т ԓ ё н _ ӄ у н _  ԓ е ԓ ю _  н э _ а н ы _ 
гыттакавӄооԓгиӈа гинэгнинтыԓин ӄунԓеԓюнэ ынык	 г ы т т а к а в _  ӄ о о _  ԓ г и _  ӈ а _ г _  и н э _  г н _  и н т ы _  ԓ и н _ ӄ у н _  ԓ е ԓ ю _  н э _ ы н ы _  к _ 
гиӈкы	 г _  и ӈ _  к ы _ 
рирэннин ԓюур ынӄэн	 р и р _ эн _ ни _ н _ ԓ ю у р _ ы н ӄ э н _ 
аԓякватыткынык	 а ԓ я _  к в а т ы _  т к ы н ы _ к _ 
аԓякват 	 а ԓ я _  к в а _  т _ _ 
ӈан орвывынгыргык	 ӈ а н _ о р в ы _  в ы н г ы р г ы _  к _ 
рывоԓватытваԓьын ӈан риивтэгнык	 р ы _  в о ԓ в _  а т ы _  т в а _  ԓ ь ы _ н _ ӈ а н _ р и и в _  т э г н ы _ к _ 
ынӄэн ынкъам	 ы н ӄ э н _ ы н к ъ а м _ 
ынкы рирэннин	 ы н _ кы _ р и р _ эн _ ни _ н _ 
ынӄо пиринин томгэнырыкы рыԓьэтэннин	 ы н ӄ о _ п и р и _ ни _ н _ т о м г э _  н ы _  р ы _ кы _ р ы _  ԓ ь э т _ эн _ ни _ н _ 
ынкы намӈыԓёйвын	 ы н _ кы _ н а _  м ӈ ы ԓ ё _  й в ы _  н _ 
ванэван ымы ночнэнат	 в а н э в а н _ ы м ы _ н о ч н _  э н а _ т _ 
миӈкыри ӄун	 м и ӈ _ кы _ ри _ ӄун _ 
амайыԓгавкы аатчеӄӄай нэтэнринӈынъюн	 а м _  а й ы ԓ _  г а в _  к ы _ а а _  т _  ч е ӄ _ ӄай _ н э т э н _  р и н _  ӈ ы н ъ ю _  н _ 
ынӄэн пэрэёӄай ынкъам намӈыԓён нэмэ ӄынвэр пыӈыԓтэԓгъэ ытԓёнаӄай нивӄин ынраӄым	 ы н ӄ э н _ п э р э ё _  ӄ а й _ ы н к ъ а м _ н а _  м ӈ ы ԓ ё н _ н э м э _ ӄ ы н в э р _ п ы ӈ ы ԓ _ тэԓ _  г ъ _ э _ ы т ԓ ё н а _  ӄ а й _ н _  и в _ ӄин _ ы н р а _  ӄ ы м _ 
иам ԓыгэн ӄун ныԓгиниквыӄин гэтэйкыԓин энмычгын ыныграк камԓеԓы	 и а м _ ԓ ы г э н _ ӄ у н _ н ы _ ԓги _  н _  и к _ вы _  ӄ и н _ г э _  т э й к ы _ ԓин _ э н м ы ч _ гы _ н _ ы н ы _  г р а _ к _ к а м ԓ _ еԓы _ 
иӈӄун мэӈин эвнэԓӄыткэ нитгъэн	 и ӈ ӄ у н _ м э ӈ _ ин _ э в н э _  ԓ ӄ ы т _  к _ э _ н _  и т _  г ъ э _ н _ 
ынӄо игыр ԓьэԓеӈкы ынраӄ гимԓыттъивыԓин энмээм ынӄэным	 ы н ӄ о _ и г ы р _ ԓ ь э ԓ е ӈ _ кы _ ы н р а _ ӄ _ г _  и м ԓ ы _  т т ъ и в ы _  ԓ и н _ э н м э э м _ ы н ӄ э н ы м _ 
энмычгын гатарӄойвэнӈачгатԓен таӈэтъо таӈъаӄаттаты гэнъэтԓин ынӄо пԓыткуй пыӈыԓтэԓык	 э н м ы ч _ гы _ н _ г а _  т а р _  ӄ о й в э _  н ӈ а _  ч г _ ат _ ԓен _ т а ӈ _  э т ъ о _ т а ӈ _  ъ а ӄ а т т _ аты _ г э _ нъэт _ ԓин _ ы н ӄ о _ п ԓ ы т к у _  й _ п ы ӈ ы ԓ _  т э ԓ ы _ к _ 
ӄунԓеԓюнэ ивнин ынӄо ивнинэт	 ӄ у н _  ԓ е ԓ ю _  н э _ и в _ ни _ н _ ы н ӄ о _ и в _ ни _  н э _ т _ 
тумгыт ӄунԓеԓюнэ ынӄо ӄытгъи ынръа ӈан гаԓгэчаӈыттатчаԓенат	 т у м г ы _ т _ ӄ у н _  ԓ е ԓ ю _  н э _ ы н ӄ о _ ӄ ы т _ гъ _ и _ ы н р ъ а _ ӈ а н _ г а _ ԓгэ _  ч а ӈ ы т т а _  т ч а _  ԓ е н а _ т _ 
ивнинэт ӄунԓеԓюнэ нивӄинэт ытри	 и в _ ни _  н э _ т _ ӄ у н _  ԓ е ԓ ю _ нэ _ н _ ив _  ӄ и н э _ т _ ы т р и _ 
наӄам ӄунԓеԓю ныԓгэнанӈэнаӄэн гатваԓен тэӈвэнԓыги ԓёӈытва нынтыӄин	 н а ӄ а м _ ӄ у н _  ԓ е ԓ ю _ ны _  ԓ г э _  н а _  н _  ӈ э н а _  ӄ э н _ г а _ тва _ ԓен _ т э ӈ _  в э н ԓ ы г и _ ԓ ё ӈ ы _ тва _ н ы _  н т ы _ ӄин _ 
ынӄо ивнинэт ӄунԓеԓюнэ ынӈатаԓ ымы мытратвыгыт эвыр	 ы н ӄ о _ и в _ ни _  н э _ т _ ӄ у н _  ԓ е ԓ ю _  н э _ ы н ӈ а _ таԓ _ ы м ы _ м ы т _  р а _  т в ы _  г ы т _ э в ы р _ 
ранмыӈыткы мотԓынто эчги ынӈин	 р а _  н м ы _  ӈ ы _  т к ы _ м о т ԓ ы н т о _ э ч г и _ ы н ӈ и н _ 
ивыпԓыткук ынӄэнат ӄунԓеԓю ганӈэнайпыԓен ынкъам гантосӄычатԓен пойгын	 и в ы _  п ԓ ы т к у _ к _ ы н ӄ э н а _  т _ ӄ у н _  ԓ е ԓ ю _ г а _  н ӈ э н а _ йпы _ ԓен _ ы н к ъ а м _ г а _  н т о _  с ӄ ы ч а _ т _ ԓен _ п о й г ы _ н _ 
пиринин ынӄо ярачыкогты пиӈкугъи ынкы	 п и р и _ ни _ н _ ы н ӄ о _ я р а _  ч ы к о _ гты _ п и ӈ к у _ гъ _ и _ ы н _ кы _ 
тымыткойвынэнат таӈымыԓьо ынӄо ӈытогъэ аатчеӄӄай ивнин ӄунԓеԓюнэ	 т ы _  м ы т к о _ йвы _ н _  э н а _ т _ т а ӈ _ ымыԓьо _ ы н ӄ о _ ӈ ы т о _ гъ _ э _ а а _  т _  ч е ӄ _ ӄай _ и в _ ни _ н _ ӄ у н _ ԓеԓю _  н э _ 
энмэч моогты	 э н м э ч _ м о о _  г т ы _ 
ӄыԓӄытги ынкъам ӄавэръэпыгэ	 ӄ ы _  ԓ ӄ ы т _ г _ и _ ы н к ъ а м _ ӄ а в э р ъ _ эпы _  г _ э _ 
аатчеӄӄай ӄытгъи наӄам иръычвыткыԓьин уйӈэ ԓыгэн ӄун ӄэтывъэӈӈоԓьыӄай ынкъам пыкиргъи	 а а _  т _  ч е ӄ _ ӄай _ ӄ ы т _ гъ _ и _ н а ӄ а м _ и р ъ ы ч в ы т к ы _  ԓ ь _  и н _ у й ӈ э _ ԓ ы г э н _ ӄ у н _ ӄ э т ы _  в ъ э _  ӈ ӈ о _  ԓ ь ы _  ӄ а й _ ы н к ъ а м _ п ы к и р _ гъ _ и _ 
муук ӄоныръым нэмэ ирэпиӄытъымынэ	 м у у _  к _ ӄ о н ы _ р _ ъым _ н э м э _ и р э _  п и ӄ ы _  т _  ъ ы м _  ы н э _ 
гэнԓьэтэтԓин нанавэръэпатъёгъан ԓыгитэӈэвиръэ ынӄо эквэтгъэт нэмэ ынкэгйит аны ӄынвэр вуԓӄытвий	 г э _  н _  ԓ ь э т _ эт _ ԓин _ н _  а н а _  в э р ъ _  э п а т ъ ё _  г ъ а _ н _ ԓ ы г и т э ӈ _  э в и р _  ъ _ э _ ы н ӄ о _ э к в э т _  г ъ э _ т _ н э м э _ ы н к э г _ йит _ а н ы _ ӄ ы н в э р _ в у ԓ ӄ ы _ тви _  й _ 
ԓюур ынкы эмԓыттъэнмиӈын нэԓьун ӄэгԓынангэт ынӈин ваԓьын гэтэйкыԓин	 ԓ ю у р _ ы н _ кы _ э м _  ԓ ы т т _  ъ э н м и ӈ ы _  н _ н э _  ԓ ь у _ н _ ӄ э г ԓ ы _ нан _ гэт _ ы н ӈ и н _ в а _ ԓьы _ н _ г э _  т э й к ы _ ԓин _ 
пыкиргъэт ынкы ԓыгэн	 п ы к и р _  г ъ э _ т _ ы н _ кы _ ԓ ы г э н _ 
гыргоԓягты ныгитэӄин наӄам	 г ы р г о ԓ я _ гты _ ны _  г и т э _  ӄ и н _ н а ӄ а м _ 
вусӄымчыку мачванэван нывытрэтын тарӄойвэйӈын ынкы ӄэйыӄын чимгьугъи тумгэӄэй ӄунԓеԓю нивӄин миӈкыри мынынтын ынӄо ивнин	 в у с ӄ ы м _ чыку _ м а ч в а н э в а н _ н ы _  в ы т р э т ы _ н _ т а р _  ӄ о й в э _  й ӈ ы _ н _ ы н _ кы _ ӄ э й ы ӄ ы _ н _ ч и м г ь у _  г ъ _ и _ т у м г э _ ӄэй _ ӄ у н _  ԓ е ԓ ю _ н _ ив _  ӄ и н _ м и ӈ _ кы _ ри _ м ы н ы _ нты _  н _ ы н ӄ о _ и в _ ни _ н _ 
ӄунԓеԓюнэ ирэпиӄытъым ынӄо	 ӄ у н _  ԓ е ԓ ю _  н э _ и р э _  п и ӄ ы _ т _  ъ ы м _ ы н ӄ о _ 
гэквэтԓин ирэпиӄытъым нэмэ пыкиргъи	 г _  э к в э т _ ԓин _ и р э _  п и ӄ ы _ т _  ъ ы м _ н э м э _ п ы к и р _ гъ _ и _ 
ирэпиӄытъым аԓваԓьэнаръэтгыпы	 и р э _  п и ӄ ы _ т _  ъ ы м _ а ԓ в а _  ԓ ь _  э н а р ъ э т _ гыпы _ 
ивнин гыттэпычьын маравраткэн ынӄо кыԓгытвынин	 и в _ ни _ н _ г ы т _  т э п ы _ чьы _ н _ м а р а в р а т _  к э н _ ы н ӄ о _ к ы ԓ г ы т в ы _  н и н _ 
ынин эԓгар эмъаԓвэнӄор наӄам майӈыԓьэӈгыргыԓьын эвыр	 ы н _  и н _ э ԓ г а _ р _ э м _  ъ а ԓ в _  э н _  ӄ о р _ н а ӄ а м _ м а й ӈ ы _  ԓ ь э ӈ _  г ы р г ы _  ԓ ь ы _ н _ э в ы р _ 
нирвыӄинэт ынин ԓьэӈгыргыт ӄаӈаэвԓявэԓгиӈын рырыткунин	 н _  и р в ы _  ӄ и н э _ т _ ы н _  и н _ ԓ ь э ӈ _  г ы р г ы _  т _ ӄ а ӈ а _  э в ԓ я в э _  ԓ г и _  ӈ ы _  н _ р ы р ы _ тку _  н и _ н _ 
ынкъам ръаратвавэԓнэн эмъаԓвэнӄор ынӄо чигԓемнин эмъаԓвэнӄор аны ԓыгэн эмъаԓвэнӄааӄай	 ы н к ъ а м _ р ъ а р а _  т в а _  в э ԓ _  н э _ н _ э м _  ъ а ԓ в _  э н _  ӄ о р _ ы н ӄ о _ ч и г ԓ е м _  н и н _ э м _  ъ а ԓ в _  э н _  ӄ о р _ а н ы _ ԓ ы г э н _ э м _  ъ а ԓ в _  э н _  ӄ а а _  ӄ а й _ 
гавэԓёвъяԓгыткоръэԓяԓен	 г а _  в э ԓ ё _  в ъ я ԓ г ы _  т к о _  р ъ э ԓ я _  ԓ е н _ 
гыргоԓягты ԓыгэн таӈамԓьэӈгырга ныкэӈунэӈэткуӄин	 г ы р г о ԓ я _ гты _ ԓ ы г э н _ т а ӈ _  а м _  ԓ ь э ӈ _  г ы р г а _ н ы _  к э _  ӈ у н _  э ӈ э _  т к у _  ӄ и н _ 
гыргоԓягты тыԓяма ԓыгэн ытръэч	 г ы р г о ԓ я _ гты _ т ы ԓ я _ ма _ ԓ ы г э н _ ы т р ъ э ч _ 
яаԓгыткат ныкэнчиӄыткуӄинэт ӄуйвик яноткэнатым ымы таӈванэван нытрунэт	 я а ԓ г ы _ тка _  т _ н ы _  к э н _ чиӄы _ тку _ ӄинэ _ т _ ӄ у й в и _ к _ я н о т _  к э н а _  т ы м _ ы м ы _ т а ӈ _  в а н э в а н _ н ы _  т р у _ нэ _ т _ 
ӄуйвик	 ӄ у й в и _ к _ 
ԓюур ынкэсӄэтгъи эԓгар эмъаԓвэнӄор	 ԓ ю у р _ ы н _  к э с ӄ э т _ гъ _ и _ э ԓ г а _ р _ э м _  ъ а ԓ в _  э н _  ӄ о р _ 
 ынко рэмыннуӈгъи этын	 _ ы н _  к о _ р э м ы н н у ӈ _ гъ _ и _ э т ы _ н _ 
ынин тумгэӄэй ӄунԓеԓю ынӄо	 ы н _  и н _ т у м г э _ ӄэй _ ӄ у н _  ԓ е ԓ ю _ ы н ӄ о _ 
гиԓгыйиквиԓин ӄунԓеԓю гыргоԓягты эмъаԓвэӄааӄайым	 г _  и ԓ г ы _  й и к в и _  ԓ и н _ ӄ у н _ ԓеԓю _ г ы р г о ԓ я _ гты _ э м _  ъ а ԓ в э _  ӄ а а _  ӄ а й _  ы м _ 
ынкэсӄык ныкытъыматӄэн ынкъым тинунин	 ы н _  к э с _  ӄ ы к _ н ы _  к ы _  т _  ъ ы м _  а т _  ӄ э н _ ы н _  к _  ъ ы м _ т и н у _  н и _ н _ 
ынкасӄэты этын эмъаԓвэнӄаата ынкы	 ы н _  к а с ӄ э т ы _ э т ы _  н _ э м _  ъ а ԓ в _  э н _  ӄ а а т _  а _ ы н _ кы _ 
таӈэтъо гакоргавԓен ӄунԓеԓю ынӄо нэнайӈоӄэн	 т а ӈ _  э т ъ о _ г а _  к о р г а в _  ԓ е н _ ӄ у н _  ԓ е ԓ ю _ ы н ӄ о _ н _  э н а _  й ӈ о _  ӄ э н _ 
ынкэсӄык эмъаԓвэнӄор миӈкыри	 ы н _  к э с _  ӄ ы к _ э м _  ъ а ԓ в _  э н _  ӄ о р _ м и ӈ _ кы _ ри _ 
ӄун амкоргава	 ӄ у н _ а м к о _ ргав _ а _ 
гакоргавԓен ӄунԓеԓю ынӄо нэнайӈоӄэн ынкэсӄык эмъаԓвэнӄор миӈкыри ӄун	 г а _  к о р г а в _ ԓен _ ӄ у н _  ԓ е ԓ ю _ ы н ӄ о _ н _  э н а _  й ӈ о _  ӄ э н _ ы н _  к э с _  ӄ ы к _ э м _  ъ а ԓ в _  э н _  ӄ о р _ м и ӈ _ кы _ ри _ ӄ у н _ 
амкоргава ынӄо тиӈунинэт тумгыт ынкъам	 а м к о _ ргав _ а _ ы н ӄ о _ т _  и ӈ у _ ни _  н э _ т _ т у м г ы _ т _ ы н к ъ а м _ 
раԓегъат ԓыгэн эвтыԓягты	 р а ԓ е _  г ъ а _  т _ ԓ ы г э н _ э в т ы ԓ я _ гты _ 
амыным эвын ынкы нытвачгатӄэн мотԓынтон ярайӈын	 а м _ ыным _ э в ы н _ ы н _ кы _ н ы _ тва _  ч г _ ат _ ӄэн _ м о т ԓ ы н т о _  н _ я р а _  й ӈ ы _ н _ 
 эвын ныԓгэнымайыӈӄэначгын	 _ э в ы н _ н ы _  ԓ г э _  н ы _  м а й ы ӈ _ ӄэначгы _ н _ 
вынэ ныкитэ вусӄымчыку	 в ы н э _ н ы _  к и т _ э _ в у с ӄ ы м _ чыку _ 
пыкиргъэт ынкы	 п ы к и р _  г ъ э _ т _ ы н _ кы _ 
ратагнык ӄунԓеԓюнэ чиниткин эвторвыӄай	 р а _  т а г н ы _ к _ ӄ у н _  ԓ е ԓ ю _  н э _ ч и н и т _  к и н _ э в т о р в ы _  ӄ а й _ 
ратчаннэн ынкъам ыръэ нэнаркыпчыткоӄэнат вивтыт ԓюур рай кыявычгатгъэ мотԓынтойӈын	 р а т ч а н _  н э _  н _ ы н к ъ а м _ ы р ъ _ э _ н _  э н а _  р к ы п ч ы т к о _ ӄэна _ т _ в и в т ы _ т _ ԓ ю у р _ р а й _ к ы я в ы _  ч г _ ат _ гъэ _ м о т ԓ ы н т о _  й ӈ ы _ н _ 
нивӄин ӄунԓеԓюнэ нинивӄин энмэч эӄыԓпэ ӄынтогэ вай	 н _  и в _ ӄин _ ӄ у н _  ԓ е ԓ ю _  н э _ н _  и н _ ив _  ӄ и н _ э н м э ч _ э ӄ ы ԓ п э _ ӄ ы _  н т о _ г _ э _ в а й _ 
мытъатчаркынэгыт еп	 м ы т _  ъ а т ч а _ ркын _ эгыт _ е п _ 
тыкынкэргыпатыркын вынэ	 т ы _  к ы н _  к э р _  г ы п а т ы _  р к ы н _ в ы н э _ 
нэнаԓгэнтэрӈыръовӄэнат ынин нэнэнэт ӄытԓыгъим	 н _  э н а _  ԓ г э _  н т _  э р ӈ ы _  р ъ о в _  ӄ э н а _ т _ ы н _  и н _ н э н э н э _ т _ ӄ ы т ԓ ы г _ ъ _ и _ м _ 
нэнатынпычерӄэнат чиниткин	 н _  э н а _  т ы н п ы _  ч е р _  ӄ э н а _ т _ ч и н и т _ кин _ 
эккэӄэгти ивнин	 э к к э _  ӄ э г _ ти _ и в _ ни _ н _ 
ӄунԓеԓюнэ эӄыԓпэ аны	 ӄ у н _  ԓ е ԓ ю _  н э _ э ӄ ы ԓ п э _ а н ы _ 
ӄынтогэ атчавооргэгыт еп ӈэвъэн	 ӄ ы _  н т о _ г _ э _ а т ч а в _  о о р г _  э г ы т _ е п _ ӈ э в ъ э _ н _ 
кэргыпыркын ӄытԓыгъим	 к э р г ы _  п ы _  р к ы н _ ӄ ы т ԓ ы г _ ъ _  и _ м _ 
	 _ 
тымыркынэн эчги ынӄэн тымыткопԓытконэнат эккэӄэгти	 т ы _  м ы р к ы н э _ н _ э ч г и _ ы н ӄ э н _ т ы _  м ы т к о _  п ԓ ы т к о _  н э _ на _ т _ э к к э _  ӄ э г _ ти _ 
пԓыткугъи ченэтрайыръытагэнӈыԓьатык ԓюур	 п ԓ ы т к у _  г ъ _ и _ ч е н э _ т _  р а _  й ы р ъ ы _  т а г э н ӈ ы _  ԓ ь а _  т ы к _ ԓ ю у р _ 
гыргоԓягты пэӈкочгатгъэ мотԓынтойӈын	 г ы р г о ԓ я _ гты _ п э ӈ к о ч г _  а т _  г ъ э _ м о т ԓ ы н т о _  й ӈ ы _ н _ 
рынооргык ӄачайпы рыранэн	 р ы н о о р г ы _  к _ ӄ а ч а _  й п ы _ р ы р а _  н э н _ 
рэтэм ынкъам пиӈкугъи	 р э т э м _ ы н к ъ а м _ п и ӈ к у _ гъ _ и _ 
ынӄоры гапойгыма нутэсӄык иргъи ӄунԓеԓюӄэйынэ	 ы н ӄ о р ы _ г а _  п о _ йгым _ а _ н у т э _ с _  ӄ ы к _ и р _ гъ _ и _ ӄ у н _  ԓ е ԓ ю _  ӄ э й _  ы н _  э _ 
ынанчиӄай гапойгыма пэнрынэн аны гапойгыԓьатмаравԓенат ынкы	 ы н а н _  ч и _ ӄай _ г а _  п о _ йгым _ а _ п э н р ы _  н э н _ а н ы _ г а _  п о й г ы _  ԓ ь а _  т _  м а р а в _  ԓ е н а _ т _ ы н _ кы _ 
ӄынвэр ԓюур	 ӄ ы н в э р _ ԓ ю у р _ 
пойгыкэн пыԓвынтын эрэтгъи эмуттэ чит гапойгыԓьатԓен	 п о й г ы _  к э н _ п ы ԓ в ы н т ы _  н _ э р э т _ гъ _ и _ э м у т _  т э _ ч и т _ г а _  п о й г ы _ ԓьат _ ԓен _ 
ӄэйыӄын ынӄо ӄунԓеԓюнэ мынгычвэтконэн уйӈэ амынгыка рытчынин	 ӄ э й ы ӄ ы _ н _ ы н ӄ о _ ӄ у н _ ԓеԓю _  н э _ м ы н _  г ы ч в э _  т к о _  н э _  н _ у й ӈ э _ а м _  ы н г ы _ к _  а _ р ы т ч ы _ ни _ н _ 
ынӄо	 ы н ӄ о _ 
пынԓёнэн ӄунԓеԓюнэ ыныкым танӈырат тумгу	 п ы н ԓ ё _ нэн _ ӄ у н _  ԓ е ԓ ю н _  э _ ы н ы _  к ы м _ т а н ӈ ы _  р а _  т _ т у м г у _ 
нитӄинэт ынӄэнат гаймычьыԓьыт наӄам ымы ӈэԓвыԓьык ӄорагынрэтыԓьо нитӄинэт	 н _  и т _  ӄ и н э _ т _ ы н ӄ э н а _ т _ г _  а й м ы _ чьы _  ԓ ь ы _ т _ н а ӄ а м _ ы м ы _ ӈ э ԓ в ы _ ԓьы _ к _ ӄ о р а _  г ы н р э т ы _  ԓ ь _  о _ н _  и т _  ӄ и н э _ т _ 
ӈъочьыӄагтэ ытԓёным ныԓгитэӈычьэтӄин ныԓгинымэԓьэв нынымытваӄэн	 ӈ ъ о _ чьы _  ӄ а г _ тэ _ ы т ԓ ё н ы м _ н ы _ ԓги _  т э ӈ ы _ чь _ эт _  ӄ и н _ н ы _  ԓ г и _ ны _  м э ԓ ь э в _ н ы _  н ы _ мытва _ ӄэн _ 
эвыр ынӄэн ӈэнри ныӄамэтвасӄэвӄэн	 э в ы р _ ы н ӄ э н _ ӈ э н _  р и _ н ы _  ӄ а м э т в а _  с ӄ э в _ ӄэн _ 
гаймычьыԓьэты ынӄо	 г _  а й м ы _ чьы _ ԓь _  э т ы _ ы н ӄ о _ 
ӄунԓеԓюнэ ивнинэт	 ӄ у н _  ԓ е ԓ ю _  н э _ и в _ ни _  н э _ т _ 
тумгыт ӈэԓвыԓ	 т у м г ы _ т _ ӈ э ԓ в ы ԓ _ 
йытыйгот ӄынтыгыткы	 й ы т ы _ йгот _ ӄ ы н т ы _  г ы т к ы _ 
мачынан ынан чинит	 м а ч ы _ нан _ ы н а н _ ч и н и т _ 
ӈэԓвыԓ нырэннин	 ӈ э ԓ в ы ԓ _ н ы _  р э н _  н и _ н _ 
ынӄо ӄунԓеԓю	 ы н ӄ о _ ӄ у н _ ԓеԓю _ 
танӈырагты	 т а н ӈ ы _  р а _ гты _ 
ӄытгъи пыкиргъи	 ӄ ы т _ гъ _ и _ п ы к и р _ гъ _ и _ 
танӈырак ивниэт	 т а н ӈ ы _  р а _  к _ и в н _  и э т _ 
ӄунԓеԓюнэ ԓюур вай	 ӄ у н _  ԓ е ԓ ю _  н э _ ԓ ю у р _ в а й _ 
моогъат ырыткуԓьэтык ытри ӄонԓяԓёна ӄунԓеԓюнэ тытыԓ рыныманнэн	 м о о _  г ъ а _ т _ ы р ы т к у _  ԓ ь _  э т ы к _ ы т р и _ ӄ о н ԓ я _  ԓ ё н _  а _ ӄ у н _  ԓ е ԓ ю _ нэ _ т ы _  т ы ԓ _ р ы н ы _ ман _  н э _ н _ 
ынкъам ԓыгэн ынкы	 ы н к ъ а м _ ԓ ы г э н _ ы н _ кы _ 
нуԓвыӄин аны	 н _  у ԓ в ы _  ӄ и н _ а н ы _ 
ынкы ԓыгэн	 ы н _ кы _ ԓ ы г э н _ 
ярачыко ныԓӄэгнэвъюуӄин	 я р а _  ч ы к о _ н ы _  ԓ _  ӄ э г н э _  в ъ ю у _  ӄ и н _ 
ԓюур ытри	 ԓ ю у р _ ы т р и _ 
тэӈъэмикэ нъэԓгъэт	 т э ӈ _  ъ э м и _  к _ э _ н _  ъ э ԓ _  г ъ э _ т _ 
"
"	
